,Test Errors,Test Error Rate,Test False Positives,Train Accuracy,Train Size,Test Size,Test Accuracy,Test False Negatives
400301,238,25.6465517241,119,0.935454126325,2169,928,74.3534482759,119
400309,217,31.9587628866,30,0.930837563452,1576,679,68.0412371134,187
400308,232,23.3635448137,122,0.929218817436,2317,993,76.6364551863,110
412281,25,14.2857142857,5,0.967980295567,406,175,85.7142857143,20
412280,26,14.7727272727,15,0.97542997543,407,176,85.2272727273,11
412287,40,22.7272727273,22,0.931873479319,411,176,77.2727272727,18
412284,30,17.1428571429,6,0.970802919708,411,175,82.8571428571,24
400570,96,17.1735241503,75,0.966153846154,1300,559,82.8264758497,21
400255,141,27.2200772201,106,0.878863826232,1197,518,72.7799227799,35
412283,30,16.9491525424,21,0.9804400978,409,177,83.0508474576,9
412282,23,13.0681818182,13,0.940594059406,404,176,86.9318181818,10
400176,189,19.2073170732,149,0.956214064573,2261,984,80.7926829268,40
412433,4,5.26315789474,4,0.983333333333,180,76,94.7368421053,0
400239,168,17.4817898023,61,0.955156950673,2230,961,82.5182101977,107
400238,308,31.0797174571,11,0.924870466321,2316,991,68.9202825429,297
400235,87,11.2113402062,60,0.968906163243,1801,776,88.7886597938,27
400234,73,9.28753180662,30,0.978142076503,1830,786,90.7124681934,43
400237,168,26.88,6,0.953960731212,1477,625,73.12,162
400230,176,34.375,4,0.952420701169,1198,512,65.625,172
400233,202,34.8275862069,16,0.93396918562,1363,580,65.1724137931,186
400232,110,21.484375,32,0.951342281879,1192,512,78.515625,78
412436,3,3.65853658537,3,0.994708994709,189,82,96.3414634146,0
400409,241,26.7184035477,28,0.932451582428,2117,902,73.2815964523,213
400406,62,12.3260437376,19,0.979814970563,1189,503,87.6739562624,43
400407,161,23.5380116959,103,0.940843297671,1589,684,76.4619883041,58
400404,76,9.66921119593,20,0.975929978118,1828,786,90.3307888041,56
412437,6,7.5,6,0.984042553191,188,80,92.5,0
400402,306,36.690647482,10,0.935983479608,1937,834,63.309352518,296
400403,216,35.8803986711,7,0.938428874735,1413,602,64.1196013289,209
400400,86,14.0983606557,54,0.970983722576,1413,610,85.9016393443,32
400077,58,13.488372093,7,0.978303747535,1014,430,86.511627907,51
412463,1,1.21951219512,1,1.0,190,82,98.7804878049,0
412462,1,1.21951219512,1,0.984042553191,188,82,98.7804878049,0
412461,2,2.5974025974,0,0.988888888889,180,77,97.4025974026,2
412460,2,2.43902439024,2,0.989473684211,190,82,97.5609756098,0
400071,92,13.2756132756,73,0.960990712074,1615,693,86.7243867244,19
412465,2,2.43902439024,1,0.989473684211,190,82,97.5609756098,1
412464,4,4.93827160494,3,0.989417989418,189,81,95.0617283951,1
412469,1,1.23456790123,1,0.983783783784,185,81,98.7654320988,0
412468,1,1.33333333333,1,1.0,170,75,98.6666666667,0
412265,20,11.3636363636,2,0.967821782178,404,176,88.6363636364,18
412308,19,11.1764705882,6,0.979539641944,391,170,88.8235294118,13
400283,199,21.5367965368,126,0.919481721425,2161,924,78.4632034632,73
412261,22,10.7317073171,4,0.978813559322,472,205,89.2682926829,18
400285,72,16.5898617512,15,0.976166832175,1007,434,83.4101382488,57
412263,22,11.2244897959,6,0.98233995585,453,196,88.7755102041,16
412302,32,18.0790960452,19,0.967980295567,406,177,81.9209039548,13
412303,26,14.7727272727,10,0.970802919708,411,176,85.2272727273,16
400122,292,30.9978768577,19,0.93146274149,2174,942,69.0021231423,273
412269,26,15.1162790698,6,0.967581047382,401,172,84.8837209302,20
412307,13,7.47126436782,1,0.984848484848,396,174,92.5287356322,12
412305,25,14.2045454545,9,0.941320293399,409,176,85.7954545455,16
400055,144,15.0943396226,36,0.967042889391,2215,954,84.9056603774,108
412417,4,4.87804878049,4,0.983870967742,186,82,95.1219512195,0
412414,4,4.87804878049,4,0.973684210526,190,82,95.1219512195,0
412415,3,3.65853658537,2,0.994680851064,188,82,96.3414634146,1
412412,14,18.9189189189,11,0.988165680473,169,74,81.0810810811,3
412413,5,6.09756097561,5,0.984126984127,189,82,93.9024390244,0
412410,13,15.8536585366,2,0.989361702128,188,82,84.1463414634,11
400052,65,15.1515151515,42,0.982160555005,1009,429,84.8484848485,23
400058,120,12.7253446448,51,0.957136342909,2193,943,87.2746553552,69
412418,12,14.8148148148,6,0.978723404255,188,81,85.1851851852,6
412419,8,10.2564102564,8,0.972375690608,181,78,89.7435897436,0
412441,3,3.7037037037,2,0.989417989418,189,81,96.2962962963,1
412443,2,2.46913580247,1,0.994680851064,188,81,97.5308641975,1
412442,1,1.28205128205,1,0.994652406417,187,78,98.7179487179,0
412444,3,3.65853658537,2,0.994594594595,185,82,96.3414634146,1
400630,87,24.5070422535,18,0.96662693683,839,355,75.4929577465,69
400141,71,16.2100456621,61,0.980353634578,1018,438,83.7899543379,10
400636,48,13.3333333333,18,0.979418886199,826,360,86.6666666667,30
400639,55,15.8501440922,52,0.963054187192,812,347,84.1498559078,3
400638,45,12.5348189415,14,0.968899521531,836,359,87.4651810585,31
412446,1,1.21951219512,1,0.984210526316,190,82,98.7804878049,0
400271,140,23.0642504119,38,0.930914166085,1433,607,76.9357495881,102
412250,58,20.4946996466,16,0.976958525346,651,283,79.5053003534,42
400273,106,12.4852767962,63,0.971585244267,2006,849,87.5147232038,43
400274,141,32.1184510251,19,0.924418604651,1032,439,67.8815489749,122
400277,97,17.2597864769,10,0.975609756098,1312,562,82.7402135231,87
400276,83,18.9931350114,7,0.97756097561,1025,437,81.0068649886,76
400279,59,12.3949579832,22,0.980108499096,1106,476,87.6050420168,37
400278,218,23.044397463,135,0.934575193094,2201,946,76.955602537,83
400442,166,42.0253164557,5,0.93137254902,918,395,57.9746835443,161
400379,214,32.3262839879,25,0.9238776838,1537,662,67.6737160121,189
400440,153,17.1717171717,65,0.940105414471,2087,891,82.8282828283,88
400441,55,13.0952380952,12,0.982635342186,979,420,86.9047619048,43
400371,230,33.381712627,10,0.935643564356,1616,689,66.618287373,220
400373,76,11.1111111111,26,0.980697384807,1606,684,88.8888888889,50
400376,91,15.0912106136,12,0.972953736655,1405,603,84.9087893864,79
400297,41,9.95145631068,25,0.986055776892,1004,412,90.0485436893,16
412310,27,15.1685393258,21,0.970660146699,409,178,84.8314606742,6
400082,260,26.369168357,212,0.919720767888,2292,986,73.630831643,48
400080,218,23.956043956,129,0.935861423221,2136,910,76.043956044,89
400081,177,27.874015748,57,0.935483870968,1488,635,72.125984252,120
400086,65,12.7450980392,8,0.979381443299,1164,510,87.2549019608,57
400087,137,22.7574750831,77,0.936645068395,1389,602,77.2425249169,60
400089,69,13.9393939394,57,0.985306828003,1157,495,86.0606060606,12
412317,19,10.6741573034,7,0.963144963145,407,178,89.3258426966,12
412228,15,5.33807829181,7,0.986089644513,647,281,94.6619217082,8
412186,23,8.0985915493,1,0.979782270607,643,284,91.9014084507,22
412221,35,12.7272727273,8,0.974921630094,638,275,87.2727272727,27
412189,28,9.85915492958,21,0.980362537764,662,284,90.1408450704,7
412225,130,47.4452554745,37,0.909810126582,632,274,52.5547445255,93
412226,45,15.9574468085,29,0.972727272727,660,282,84.0425531915,16
400280,68,15.5606407323,10,0.9658203125,1024,437,84.4393592677,58
400019,42,7.17948717949,42,0.977071005917,1352,585,92.8205128205,0
400018,240,25.4777070064,27,0.950819672131,2196,942,74.5222929936,213
400152,210,34.9417637271,7,0.935740072202,1385,601,65.0582362729,203
400154,202,23.2451093211,13,0.964868876794,2021,869,76.7548906789,189
400157,69,10.3293413174,35,0.979098628347,1531,668,89.6706586826,34
400158,85,17.0682730924,25,0.977605512489,1161,498,82.9317269076,60
400010,190,22.4321133412,21,0.969574036511,1972,847,77.5678866588,169
400013,167,27.5577557756,52,0.938122332859,1406,606,72.4422442244,115
412451,9,11.25,3,0.994652406417,187,80,88.75,6
412456,1,1.25,1,0.973404255319,188,80,98.75,0
412457,2,2.46913580247,2,0.989417989418,189,81,97.5308641975,0
400017,117,13.5573580533,65,0.958374628345,2018,863,86.4426419467,52
409888,53,10.5367793241,30,0.976883561644,1168,503,89.4632206759,23
400335,104,20.1941747573,11,0.97506234414,1203,515,79.8058252427,93
400337,186,28.3536585366,48,0.91915175613,1509,656,71.6463414634,138
400331,344,34.7826086957,73,0.906019922044,2309,989,65.2173913043,271
400333,247,26.7605633803,19,0.927136851938,2141,923,73.2394366197,228
400648,50,13.698630137,28,0.976331360947,845,365,86.301369863,22
400640,56,15.6424581006,27,0.979393939394,825,358,84.3575418994,29
400641,88,24.7887323944,6,0.979166666667,816,355,75.2112676056,82
400643,46,12.6373626374,25,0.977541371158,846,364,87.3626373626,21
400644,78,21.9718309859,70,0.977025392987,827,355,78.0281690141,8
400645,73,20.9169054441,72,0.897342995169,828,349,79.0830945559,1
400646,15,9.61538461538,15,0.975409836066,366,156,90.3846153846,0
400647,51,14.0883977901,25,0.976019184652,834,362,85.9116022099,26
400349,75,17.7304964539,26,0.959677419355,992,423,82.2695035461,49
412382,18,14.2857142857,6,0.965397923875,289,126,85.7142857143,12
412383,42,32.0610687023,8,0.914473684211,304,131,67.9389312977,34
412386,33,29.7297297297,2,0.95703125,256,111,70.2702702703,31
412385,8,7.54716981132,0,0.984,250,106,92.4528301887,8
412388,19,17.5925925926,17,0.987951807229,249,108,82.4074074074,2
412258,25,12.077294686,2,0.985507246377,483,207,87.922705314,23
400209,175,22.9057591623,117,0.939650310209,1773,764,77.0942408377,58
400204,235,28.5540704739,96,0.932089165371,1929,823,71.4459295261,139
400206,158,17.4778761062,127,0.954115421003,2114,904,82.5221238938,31
400207,92,18.2902584493,44,0.964346349745,1178,503,81.7097415507,48
400419,127,20.8538587849,10,0.977288857346,1409,609,79.1461412151,117
400415,78,17.9310344828,40,0.970530451866,1018,435,82.0689655172,38
400414,158,15.7842157842,122,0.952421774539,2333,1001,84.2157842158,36
400417,245,24.9490835031,53,0.92987804878,2296,982,75.0509164969,192
400416,227,26.9596199525,14,0.933130699088,1974,842,73.0403800475,213
400411,152,34.6241457859,3,0.98041136141,1021,439,65.3758542141,149
400253,224,22.9743589744,59,0.938981562774,2278,975,77.0256410256,165
400343,165,16.5995975855,86,0.954565123323,2311,994,83.4004024145,79
412295,46,25.988700565,40,0.961165048544,412,177,74.011299435,6
400288,82,10.8609271523,19,0.978494623656,1767,755,89.1390728477,63
400251,241,28.4198113208,28,0.923508414074,1961,848,71.5801886792,213
412405,9,11.1111111111,9,0.989417989418,189,81,88.8888888889,0
412404,11,14.4736842105,0,0.971590909091,176,76,85.5263157895,11
400257,148,22.0238095238,104,0.927802406586,1579,672,77.9761904762,44
412407,32,40.0,3,0.909574468085,188,80,60.0,29
400114,207,26.7787839586,135,0.922041503085,1783,773,73.2212160414,72
400115,157,15.9229208925,110,0.951598962835,2314,986,84.0770791075,47
400116,229,23.0382293763,162,0.955391944565,2309,994,76.9617706237,67
412406,4,4.93827160494,4,0.983783783784,185,81,95.0617283951,0
400110,295,31.1181434599,18,0.930512249443,2245,948,68.8818565401,277
400111,250,32.2164948454,21,0.925596890616,1801,776,67.7835051546,229
412498,8,15.3846153846,0,0.983193277311,119,52,84.6153846154,8
412499,0,0.0,0,1.0,106,46,100.0,0
412497,22,36.6666666667,1,0.948905109489,137,60,63.3333333333,21
412319,16,9.0395480226,3,0.980535279805,411,177,90.9604519774,13
412252,38,15.5737704918,32,0.980322003578,559,244,84.4262295082,6
412253,22,9.44206008584,7,0.965517241379,551,233,90.5579399142,15
412254,18,7.75862068966,9,0.990583804143,531,232,92.2413793103,9
412255,27,12.5581395349,20,0.958823529412,510,215,87.4418604651,7
412256,20,9.09090909091,11,0.976470588235,510,220,90.9090909091,9
412311,25,14.2045454545,20,0.975369458128,406,176,85.7954545455,5
412259,27,14.2105263158,2,0.972222222222,432,190,85.7894736842,25
412315,26,15.0289017341,11,0.94540942928,403,173,84.9710982659,15
412314,20,12.1212121212,1,0.966836734694,392,165,87.8787878788,19
400291,253,26.2993762994,57,0.929243170622,2233,962,73.7006237006,196
400290,141,23.8578680203,46,0.939926739927,1365,591,76.1421319797,95
400060,74,14.5098039216,8,0.978650725875,1171,510,85.4901960784,66
400061,60,11.71875,23,0.983291562239,1197,512,88.28125,37
400062,157,24.8025276461,36,0.937373737374,1485,633,75.1974723539,121
400063,141,23.5785953177,85,0.931884057971,1380,598,76.4214046823,56
412401,2,2.46913580247,2,0.994680851064,188,81,97.5308641975,0
412400,2,2.43902439024,2,1.0,187,82,97.5609756098,0
412403,3,3.7037037037,3,1.0,187,81,96.2962962963,0
412402,2,2.43902439024,1,0.994736842105,190,82,97.5609756098,1
400068,90,21.2264150943,6,0.98001998002,1001,424,78.7735849057,84
412409,2,2.43902439024,2,0.989361702128,188,82,97.5609756098,0
412408,3,3.65853658537,2,0.973684210526,190,82,96.3414634146,1
400151,36,8.35266821346,16,0.98111332008,1006,431,91.6473317865,20
412458,2,2.5974025974,2,0.989247311828,186,77,97.4025974026,0
412452,6,7.5,3,0.994708994709,189,80,92.5,3
412453,8,9.75609756098,7,0.978835978836,189,82,90.243902439,1
412466,4,4.93827160494,4,0.994623655914,186,81,95.0617283951,0
400367,158,23.4421364985,11,0.979166666667,1584,674,76.5578635015,147
400366,242,25.0777202073,159,0.933983163491,2257,965,74.9222797927,83
400365,199,20.0807265388,108,0.955805892548,2308,991,79.9192734612,91
400364,296,34.3786295006,3,0.921851667496,2009,861,65.6213704994,293
400363,120,27.6497695853,16,0.947988223749,1019,434,72.3502304147,104
400249,117,24.6835443038,30,0.946188340807,1115,474,75.3164556962,87
400361,170,32.8820116054,5,0.946398659966,1194,517,67.1179883946,165
400360,135,22.4252491694,60,0.948005698006,1404,602,77.5747508306,75
400244,131,16.5404040404,34,0.970620239391,1838,792,83.4595959596,97
400245,193,25.2287581699,42,0.930219471019,1777,765,74.7712418301,151
400246,368,37.4364191251,9,0.938569548047,2279,983,62.5635808749,359
400247,99,12.3904881101,54,0.975427350427,1872,799,87.6095118899,45
400240,229,24.4919786096,89,0.937814357567,2187,935,75.5080213904,140
412454,4,5.19480519481,4,0.983870967742,186,77,94.8051948052,0
412411,1,1.25,1,0.963157894737,190,80,98.75,0
400129,236,28.0618311534,16,0.926417986714,1957,841,71.9381688466,220
400093,169,25.3373313343,5,0.932735426009,1561,667,74.6626686657,164
400097,152,29.6875,8,0.945652173913,1196,512,70.3125,144
412214,51,17.7700348432,5,0.987915407855,662,287,82.2299651568,46
412215,20,7.46268656716,11,0.982704402516,636,268,92.5373134328,9
412216,32,12.1212121212,12,0.973109243697,595,264,87.8787878788,20
412309,36,20.3389830508,17,0.956204379562,411,177,79.6610169492,19
412476,5,6.17283950617,2,0.994623655914,186,81,93.8271604938,3
412211,33,11.7021276596,3,0.981538461538,650,282,88.2978723404,30
412212,64,22.6148409894,2,0.990963855422,664,283,77.3851590106,62
412213,27,14.2857142857,2,0.974885844749,438,189,85.7142857143,25
412199,16,5.94795539033,7,0.985981308411,642,269,94.0520446097,9
400392,52,11.5044247788,24,0.985451018429,1031,452,88.4955752212,28
412196,67,23.6749116608,2,0.980122324159,654,283,76.3250883392,65
412195,14,5.09090909091,9,0.985959438378,641,275,94.9090909091,5
412194,25,8.92857142857,13,0.961948249619,657,280,91.0714285714,12
412193,20,7.06713780919,10,0.980392156863,663,283,92.9328621908,10
412192,40,14.5454545455,4,0.972179289026,647,275,85.4545454545,36
412191,36,12.7659574468,6,0.980213089802,657,282,87.2340425532,30
412190,51,18.0212014134,11,0.972222222222,648,283,81.9787985866,40
400121,148,22.0566318927,19,0.971537001898,1581,671,77.9433681073,129
400289,223,26.6109785203,16,0.931562819203,1958,838,73.3890214797,207
400124,251,29.809976247,12,0.91738469336,1973,842,70.190023753,239
400024,196,32.9966329966,28,0.940115440115,1386,594,67.0033670034,168
400025,193,20.7303974221,107,0.933888118354,2163,931,79.2696025779,86
400027,67,10.9836065574,39,0.973201692525,1418,610,89.0163934426,28
400021,192,23.3292831106,84,0.942066805846,1916,823,76.6707168894,108
400029,100,23.9808153477,9,0.977482088025,977,417,76.0191846523,91
412449,4,5.0,2,1.0,188,80,95.0,2
400147,56,12.9930394432,34,0.97532082922,1013,431,87.0069605568,22
412440,13,16.049382716,8,0.957219251337,187,81,83.950617284,5
400145,69,15.7534246575,55,0.972495088409,1018,438,84.2465753425,14
400144,146,15.1767151767,82,0.961330935252,2224,962,84.8232848233,64
412445,0,0.0,0,0.989247311828,186,80,100.0,0
400142,76,9.8064516129,33,0.972497249725,1818,775,90.1935483871,43
412447,0,0.0,0,0.983957219251,187,79,100.0,0
400140,293,30.2685950413,11,0.935669920142,2254,968,69.7314049587,282
412500,1,2.22222222222,1,1.0,105,45,97.7777777778,0
412501,2,7.40740740741,0,0.983870967742,62,27,92.5925925926,2
412502,1,9.09090909091,0,0.92,25,11,90.9090909091,1
400321,97,19.1699604743,16,0.971210838273,1181,506,80.8300395257,81
400320,118,17.4814814815,22,0.970440251572,1590,675,82.5185185185,96
400326,363,40.1993355482,9,0.945506692161,2092,903,59.8006644518,354
400657,116,32.1329639889,30,0.965558194774,842,361,67.8670360111,86
400656,59,17.2514619883,44,0.975796178344,785,342,82.7485380117,15
400655,41,11.4845938375,13,0.973589435774,833,357,88.5154061625,28
400654,91,25.348189415,2,0.980769230769,832,359,74.651810585,89
400653,71,19.7222222222,13,0.967703349282,836,360,80.2777777778,58
400652,46,13.0681818182,10,0.975816203144,827,352,86.9318181818,36
400651,90,26.0869565217,8,0.964601769912,791,345,73.9130434783,82
400198,201,28.2303370787,19,0.934328358209,1675,712,71.7696629213,182
412209,16,5.73476702509,12,0.978625954198,655,279,94.2652329749,4
400659,41,12.1661721068,22,0.984732824427,786,337,87.8338278932,19
400199,226,29.9734748011,97,0.916619398752,1763,754,70.0265251989,129
400211,372,38.8714733542,24,0.917647058824,2210,957,61.1285266458,348
412398,9,11.1111111111,9,0.984126984127,189,81,88.8888888889,0
400216,245,24.4267198405,102,0.931934931507,2336,1003,75.5732801595,143
412393,3,3.33333333333,2,0.980952380952,210,90,96.6666666667,1
412392,9,10.2272727273,3,0.971014492754,207,88,89.7727272727,6
412395,7,8.53658536585,7,0.994708994709,189,82,91.4634146341,0
412394,1,1.23456790123,1,0.994680851064,188,81,98.7654320988,0
412397,5,6.09756097561,5,0.994565217391,184,82,93.9024390244,0
412396,13,16.4556962025,9,0.961956521739,184,79,83.5443037975,4
412399,5,6.17283950617,5,0.978723404255,188,81,93.8271604938,0
400195,113,22.2003929273,22,0.952421410365,1177,509,77.7996070727,91
400196,55,11.1111111111,31,0.982788296041,1162,495,88.8888888889,24
400219,114,13.4911242604,64,0.964974619289,1970,845,86.5088757396,50
400218,193,28.3406754772,35,0.916197623515,1599,681,71.6593245228,158
400356,169,25.5287009063,31,0.930187459599,1547,662,74.4712990937,138
400355,100,23.7529691211,7,0.960406091371,985,421,76.2470308789,93
400352,124,28.5057471264,9,0.964532019704,1015,435,71.4942528736,115
400350,195,24.7461928934,90,0.924713584288,1833,788,75.2538071066,105
400351,67,11.2040133779,47,0.975627240143,1395,598,88.7959866221,20
400422,206,22.8634850166,31,0.929858743302,2053,901,77.1365149834,175
400424,243,28.4543325527,19,0.933966983492,1999,854,71.5456674473,224
400425,212,22.7467811159,94,0.943758573388,2187,932,77.2532188841,118
400103,221,23.2386961094,46,0.929501571621,2227,951,76.7613038906,175
400101,153,22.7002967359,78,0.930661577608,1572,674,77.2997032641,75
412327,21,12.1387283237,2,0.967581047382,401,173,87.8612716763,19
412489,2,2.5,2,0.989304812834,187,80,97.5,0
412488,0,0.0,0,0.989361702128,188,80,100.0,0
412485,5,6.17283950617,3,0.97311827957,186,81,93.8271604938,2
412484,6,7.5,5,0.984042553191,188,80,92.5,1
400109,296,30.3901437372,20,0.92617152962,2262,974,69.6098562628,276
400108,45,10.5882352941,28,0.9726443769,987,425,89.4117647059,17
412481,4,4.87804878049,4,0.984042553191,188,82,95.1219512195,0
412480,4,4.93827160494,1,0.994623655914,186,81,95.0617283951,3
412483,7,8.64197530864,6,0.989473684211,190,81,91.3580246914,1
412482,3,3.7037037037,3,0.994736842105,190,81,96.2962962963,0
412416,4,4.87804878049,2,0.989247311828,186,82,95.1219512195,2
400057,93,10.928319624,28,0.975659229209,1972,851,89.071680376,65
412430,3,3.7037037037,3,0.984126984127,189,81,96.2962962963,0
412431,4,4.93827160494,4,0.978835978836,189,81,95.0617283951,0
412432,15,19.2307692308,4,0.989189189189,185,78,80.7692307692,11
400175,64,14.6453089245,17,0.979330708661,1016,437,85.3546910755,47
412434,8,9.75609756098,7,0.983957219251,187,82,90.243902439,1
412435,16,19.512195122,0,0.968253968254,189,82,80.487804878,16
400170,194,24.4332493703,117,0.941399891481,1843,794,75.5667506297,77
400171,67,8.66752910737,17,0.979921918572,1793,773,91.3324708926,50
412438,20,25.0,19,0.989361702128,188,80,75.0,1
400076,243,25.0515463918,34,0.951944080384,2289,970,74.9484536082,209
400075,250,29.4811320755,28,0.927995971803,1986,848,70.5188679245,222
400074,97,19.8770491803,54,0.951413427562,1132,488,80.1229508197,43
400178,242,28.672985782,16,0.933161953728,1945,844,71.327014218,226
400179,136,20.8588957055,78,0.922139471903,1477,652,79.1411042945,58
400618,102,28.7323943662,16,0.935523114355,822,355,71.2676056338,86
400617,52,14.5658263305,23,0.972388955582,833,357,85.4341736695,29
400616,39,10.6557377049,19,0.964200477327,838,366,89.3442622951,20
400313,39,11.5384615385,19,0.987405541562,794,338,88.4615384615,20
400259,126,24.8031496063,17,0.946925021061,1187,508,75.1968503937,109
400311,252,41.3793103448,231,0.953438395415,1396,609,58.6206896552,21
400316,317,33.6518046709,287,0.8926144087,2207,942,66.3481953291,30
400314,250,30.9789343247,17,0.927923117993,1873,807,69.0210656753,233
400315,66,13.1212723658,49,0.973252804142,1159,503,86.8787276342,17
412294,21,12.0,5,0.965432098765,405,175,88.0,16
400252,232,27.0396270396,29,0.970381526104,1992,858,72.9603729604,203
400318,244,24.4979919679,207,0.943103448276,2320,996,75.5020080321,37
412290,25,14.0449438202,9,0.978208232446,413,178,85.9550561798,16
412292,19,10.7954545455,9,0.973236009732,411,176,89.2045454545,10
412293,15,8.62068965517,2,0.98296836983,411,174,91.3793103448,13
412474,8,9.75609756098,8,0.968253968254,189,82,90.243902439,0
412429,9,10.9756097561,9,0.968253968254,189,82,89.0243902439,0
412475,1,1.26582278481,0,0.994652406417,187,79,98.7341772152,1
412428,2,2.43902439024,2,1.0,190,82,97.5609756098,0
400663,83,23.3146067416,2,0.973715651135,837,356,76.6853932584,81
400660,60,17.3913043478,20,0.970660146699,818,345,82.6086956522,40
400661,87,25.0,7,0.96336996337,819,348,75.0,80
412477,3,3.65853658537,3,0.984126984127,189,82,96.3414634146,0
412426,1,1.23456790123,1,0.983957219251,187,81,98.7654320988,0
412471,4,4.87804878049,4,0.968253968254,189,82,95.1219512195,0
412423,3,3.7037037037,3,0.978947368421,190,81,96.2962962963,0
412202,60,21.5053763441,42,0.975572519084,655,279,78.4946236559,18
412200,43,15.3571428571,6,0.984301412873,637,280,84.6428571429,37
412421,2,2.53164556962,1,0.989247311828,186,79,97.4683544304,1
412205,68,23.7762237762,38,0.923192771084,664,286,76.2237762238,30
400227,201,29.7777777778,65,0.917661847894,1591,675,70.2222222222,136
400224,121,27.562642369,5,0.981427174976,1023,439,72.437357631,116
412208,52,18.9090909091,6,0.976265822785,632,275,81.0909090909,46
400220,108,24.6575342466,5,0.978260869565,1012,438,75.3424657534,103
400221,111,13.074204947,83,0.969160768453,1978,849,86.925795053,28
400388,183,18.5598377282,71,0.948806941432,2305,986,81.4401622718,112
400381,147,15.0460593654,98,0.962488967343,2266,977,84.9539406346,49
400380,381,38.7983706721,34,0.950912250217,2302,982,61.2016293279,347
400387,221,24.2590559824,30,0.937441204139,2126,911,75.7409440176,191
400033,231,34.0707964602,12,0.915413533835,1596,678,65.9292035398,219
400032,52,12.037037037,9,0.98321816387,1013,432,87.962962963,43
400031,86,19.8156682028,43,0.959724950884,1018,434,80.1843317972,43
400030,185,21.8934911243,143,0.918753193664,1957,845,78.1065088757,42
412470,13,16.049382716,1,0.962162162162,185,81,83.950617284,12
400036,124,14.4690781797,28,0.956434651978,1997,857,85.5309218203,96
412472,9,11.25,9,0.962962962963,189,80,88.75,0
412473,6,7.31707317073,5,0.968421052632,190,82,92.6829268293,1
400039,97,15.6957928803,23,0.975409836066,1464,618,84.3042071197,74
400038,55,12.8504672897,17,0.983951855567,997,428,87.1495327103,38
412478,2,2.43902439024,2,0.989130434783,184,82,97.5609756098,0
412479,5,6.09756097561,5,0.983957219251,187,82,93.9024390244,0
412275,20,11.2994350282,10,0.977941176471,408,177,88.7005649718,10
412272,27,15.2542372881,8,0.958435207824,409,177,84.7457627119,19
412379,14,9.52380952381,2,0.981981981982,333,147,90.4761904762,12
412270,26,14.606741573,13,0.962962962963,405,178,85.393258427,13
412271,34,19.3181818182,24,0.965936739659,411,176,80.6818181818,10
400133,199,24.3574051408,59,0.935633367662,1942,817,75.6425948592,140
400130,195,26.4227642276,71,0.927948866938,1721,738,73.5772357724,124
400137,76,15.415821501,11,0.977391304348,1150,493,84.584178499,65
400134,97,19.094488189,86,0.961538461538,1170,508,80.905511811,11
400100,236,24.4559585492,54,0.928,2250,965,75.5440414508,182
412420,15,18.9873417722,5,0.983870967742,186,79,81.0126582278,10
400090,188,26.6288951841,29,0.919902912621,1648,706,73.3711048159,159
412278,24,13.7931034483,2,0.980392156863,408,174,86.2068965517,22
412487,4,5.0,3,0.994736842105,190,80,95.0,1
400046,74,11.0283159463,10,0.97571884984,1565,671,88.9716840537,64
400047,132,21.4634146341,54,0.936717663421,1438,615,78.5365853659,78
412486,4,4.87804878049,4,0.989304812834,187,82,95.1219512195,0
400042,160,23.988005997,136,0.926395939086,1576,667,76.011994003,24
400048,198,23.8267148014,72,0.929092805005,1918,831,76.1732851986,126
412010,69,20.7207207207,11,0.978149100257,778,333,79.2792792793,58
412011,46,15.3333333333,34,0.984485190409,709,300,84.6666666667,12
400622,61,17.7325581395,43,0.980124223602,805,344,82.2674418605,18
400623,41,11.5168539326,26,0.969325153374,815,356,88.4831460674,15
400626,52,14.4846796657,29,0.977163461538,832,359,85.5153203343,23
400627,47,13.6231884058,25,0.971428571429,805,345,86.3768115942,22
400628,66,18.1818181818,59,0.953791469194,844,363,81.8181818182,7
412217,38,13.2867132867,9,0.980332829047,661,286,86.7132867133,29
400262,209,22.0,120,0.93836534167,2239,950,78.0,89
400263,195,28.0979827089,9,0.934243176179,1612,694,71.9020172911,186
400189,198,20.0,108,0.938828633406,2305,990,80.0,90
400266,264,38.3720930233,190,0.903448275862,1595,688,61.6279069767,74
400267,133,15.5373831776,23,0.971428571429,1995,856,84.4626168224,110
400183,320,37.2093023256,167,0.907769423559,1995,860,62.7906976744,153
400185,155,31.25,5,0.946689595873,1163,496,68.75,150
400184,133,21.9110378913,66,0.94495412844,1417,607,78.0889621087,67
400436,214,25.2955082742,16,0.932892730046,1967,846,74.7044917258,198
400435,205,20.5823293173,36,0.944946236559,2325,996,79.4176706827,169
400433,61,12.9237288136,27,0.979109900091,1101,472,87.0762711864,34
400348,151,17.681498829,61,0.967188288743,1981,854,82.318501171,90
400431,84,10.9947643979,42,0.973273942094,1796,764,89.0052356021,42
400345,220,43.0528375734,118,0.912060301508,1194,511,56.9471624266,102
400344,298,31.4345991561,20,0.951285520974,2217,948,68.5654008439,278
400347,218,25.4672897196,42,0.937027707809,1985,856,74.5327102804,176
400346,251,37.2956909361,1,0.929209183673,1568,673,62.7043090639,250
400341,71,16.2100456621,16,0.9736328125,1024,438,83.7899543379,55
400340,310,31.2815338042,14,0.95748373102,2305,991,68.7184661958,296
400439,274,29.8800436205,19,0.949769585253,2170,917,70.1199563795,255
400342,141,27.8656126482,5,0.983093829248,1183,506,72.1343873518,136
400310,288,31.3384113166,12,0.919384902144,2146,919,68.6615886834,276
412331,28,16.9696969697,3,0.951482479784,371,165,83.0303030303,25
412239,25,8.9605734767,4,0.987767584098,654,279,91.0394265233,21
412231,59,20.6293706294,28,0.933834586466,665,286,79.3706293706,31
412236,38,13.4275618375,5,0.982998454405,647,283,86.5724381625,33
400165,227,23.2106339468,195,0.896143733567,2282,978,76.7893660532,32
400008,378,41.5841584158,12,0.931002331002,2145,909,58.4158415842,366
400009,133,24.6296296296,32,0.93973037272,1261,540,75.3703703704,101
400160,237,28.3492822967,53,0.919670442842,1942,836,71.6507177033,184
400163,222,27.6119402985,166,0.926063829787,1880,804,72.3880597015,56
400162,80,18.3066361556,7,0.964601769912,1017,437,81.6933638444,73
412427,2,2.43902439024,2,0.978835978836,189,82,97.5609756098,0
400003,254,27.6086956522,19,0.942183163737,2162,920,72.3913043478,235
412424,10,12.3456790123,9,0.967032967033,182,81,87.6543209877,1
400006,84,19.4895591647,70,0.948361469712,1007,431,80.5104408353,14
412422,6,7.31707317073,6,0.978947368421,190,82,92.6829268293,0
400004,89,13.0498533724,29,0.97625,1600,682,86.9501466276,60
400005,67,13.4268537074,37,0.979002624672,1143,499,86.5731462926,30
400378,227,23.9957716702,62,0.93578805568,2227,946,76.0042283298,165
