,Total False Negatives,Total False Positives,Total Errors,Error Rate,Accuracy,Dataset Size
400301,196,14,210,22.6293103448,77.3706896552,928
400309,202,5,207,30.4860088365,69.5139911635,679
400308,211,35,246,24.7734138973,75.2265861027,993
412281,14,5,19,10.8571428571,89.1428571429,175
412280,16,1,17,9.65909090909,90.3409090909,176
412287,51,5,56,31.8181818182,68.1818181818,176
412284,14,1,15,8.57142857143,91.4285714286,175
400570,49,19,68,12.1645796064,87.8354203936,559
400255,187,24,211,40.7335907336,59.2664092664,518
412283,14,1,15,8.47457627119,91.5254237288,177
412282,22,7,29,16.4772727273,83.5227272727,176
400176,95,36,131,13.3130081301,86.6869918699,984
412433,2,3,5,6.57894736842,93.4210526316,76
400239,132,24,156,16.2330905307,83.7669094693,961
400238,247,12,259,26.1352169526,73.8647830474,991
400235,72,35,107,13.7886597938,86.2113402062,776
400234,59,19,78,9.92366412214,90.0763358779,786
400237,120,19,139,22.24,77.76,625
400230,128,4,132,25.78125,74.21875,512
400233,152,4,156,26.8965517241,73.1034482759,580
400232,139,7,146,28.515625,71.484375,512
412436,3,3,6,7.31707317073,92.6829268293,82
400409,182,33,215,23.8359201774,76.1640798226,902
400406,48,5,53,10.5367793241,89.4632206759,503
400407,156,8,164,23.9766081871,76.0233918129,684
400404,41,23,64,8.14249363868,91.8575063613,786
412437,1,5,6,7.5,92.5,80
400402,231,10,241,28.896882494,71.103117506,834
400403,170,6,176,29.2358803987,70.7641196013,602
400400,58,21,79,12.9508196721,87.0491803279,610
400077,53,3,56,13.023255814,86.976744186,430
412463,2,0,2,2.43902439024,97.5609756098,82
412462,0,0,0,0.0,100.0,82
412461,2,0,2,2.5974025974,97.4025974026,77
412460,1,0,1,1.21951219512,98.7804878049,82
400071,24,54,78,11.2554112554,88.7445887446,693
412465,1,0,1,1.21951219512,98.7804878049,82
412464,0,1,1,1.23456790123,98.7654320988,81
412469,1,0,1,1.23456790123,98.7654320988,81
412468,2,0,2,2.66666666667,97.3333333333,75
412265,23,0,23,13.0681818182,86.9318181818,176
412308,12,6,18,10.5882352941,89.4117647059,170
400283,262,15,277,29.9783549784,70.0216450216,924
412261,14,0,14,6.82926829268,93.1707317073,205
400285,72,5,77,17.7419354839,82.2580645161,434
412263,10,8,18,9.18367346939,90.8163265306,196
412302,16,0,16,9.0395480226,90.9604519774,177
412303,23,1,24,13.6363636364,86.3636363636,176
400122,235,16,251,26.6454352442,73.3545647558,942
412269,21,1,22,12.7906976744,87.2093023256,172
412307,6,1,7,4.02298850575,95.9770114943,174
412305,16,12,28,15.9090909091,84.0909090909,176
400055,89,33,122,12.7882599581,87.2117400419,954
412417,3,2,5,6.09756097561,93.9024390244,82
412414,0,3,3,3.65853658537,96.3414634146,82
412415,1,3,4,4.87804878049,95.1219512195,82
412412,9,1,10,13.5135135135,86.4864864865,74
412413,1,3,4,4.87804878049,95.1219512195,82
412410,2,1,3,3.65853658537,96.3414634146,82
400052,37,17,54,12.5874125874,87.4125874126,429
400058,107,15,122,12.9374337222,87.0625662778,943
412418,10,4,14,17.2839506173,82.7160493827,81
412419,1,8,9,11.5384615385,88.4615384615,78
412441,2,1,3,3.7037037037,96.2962962963,81
412443,0,0,0,0.0,100.0,81
412442,2,0,2,2.5641025641,97.4358974359,78
412444,1,2,3,3.65853658537,96.3414634146,82
400630,58,15,73,20.5633802817,79.4366197183,355
400141,13,35,48,10.9589041096,89.0410958904,438
400636,36,4,40,11.1111111111,88.8888888889,360
400639,39,4,43,12.3919308357,87.6080691643,347
400638,38,1,39,10.8635097493,89.1364902507,359
412446,0,1,1,1.21951219512,98.7804878049,82
400271,151,8,159,26.194398682,73.805601318,607
412250,55,3,58,20.4946996466,79.5053003534,283
400273,59,20,79,9.3050647821,90.6949352179,849
400274,83,21,104,23.6902050114,76.3097949886,439
400277,38,12,50,8.89679715302,91.103202847,562
400276,78,4,82,18.7643020595,81.2356979405,437
400279,26,16,42,8.82352941176,91.1764705882,476
400278,157,22,179,18.9217758985,81.0782241015,946
400442,94,7,101,25.5696202532,74.4303797468,395
400379,192,8,200,30.2114803625,69.7885196375,662
400440,173,21,194,21.77328844,78.22671156,891
400441,33,7,40,9.52380952381,90.4761904762,420
400371,211,6,217,31.4949201742,68.5050798258,689
400373,55,21,76,11.1111111111,88.8888888889,684
400376,67,10,77,12.7694859038,87.2305140962,603
400297,31,2,33,8.00970873786,91.9902912621,412
412310,11,2,13,7.30337078652,92.6966292135,178
400082,266,51,317,32.1501014199,67.8498985801,986
400080,139,37,176,19.3406593407,80.6593406593,910
400081,100,53,153,24.094488189,75.905511811,635
400086,43,6,49,9.60784313725,90.3921568627,510
400087,173,3,176,29.2358803987,70.7641196013,602
400089,32,11,43,8.68686868687,91.3131313131,495
412317,13,2,15,8.42696629213,91.5730337079,178
412228,13,6,19,6.7615658363,93.2384341637,281
412186,20,3,23,8.0985915493,91.9014084507,284
412221,9,9,18,6.54545454545,93.4545454545,275
412189,12,6,18,6.33802816901,93.661971831,284
412225,55,50,105,38.3211678832,61.6788321168,274
412226,18,5,23,8.15602836879,91.8439716312,282
400280,76,2,78,17.8489702517,82.1510297483,437
400019,6,40,46,7.86324786325,92.1367521368,585
400018,103,37,140,14.8619957537,85.1380042463,942
400152,166,7,173,28.7853577371,71.2146422629,601
400154,67,25,92,10.586881473,89.413118527,869
400157,44,14,58,8.68263473054,91.3173652695,668
400158,48,10,58,11.6465863454,88.3534136546,498
400010,65,28,93,10.9799291617,89.0200708383,847
400013,128,11,139,22.9372937294,77.0627062706,606
412451,3,1,4,5.0,95.0,80
412456,1,0,1,1.25,98.75,80
412457,1,1,2,2.46913580247,97.5308641975,81
400017,65,47,112,12.9779837775,87.0220162225,863
409888,38,7,45,8.94632206759,91.0536779324,503
400335,47,8,55,10.6796116505,89.3203883495,515
400337,214,5,219,33.3841463415,66.6158536585,656
400331,278,53,331,33.4681496461,66.5318503539,989
400333,185,21,206,22.3185265439,77.6814734561,923
400648,74,1,75,20.5479452055,79.4520547945,365
400640,55,3,58,16.2011173184,83.7988826816,358
400641,66,4,70,19.7183098592,80.2816901408,355
400643,24,5,29,7.96703296703,92.032967033,364
400644,23,10,33,9.29577464789,90.7042253521,355
400645,110,25,135,38.6819484241,61.3180515759,349
400646,1,14,15,9.61538461538,90.3846153846,156
400647,42,6,48,13.2596685083,86.7403314917,362
400349,95,3,98,23.1678486998,76.8321513002,423
412382,14,4,18,14.2857142857,85.7142857143,126
412383,32,9,41,31.2977099237,68.7022900763,131
412386,29,3,32,28.8288288288,71.1711711712,111
412385,7,2,9,8.49056603774,91.5094339623,106
412388,2,10,12,11.1111111111,88.8888888889,108
412258,8,4,12,5.79710144928,94.2028985507,207
400209,75,104,179,23.4293193717,76.5706806283,764
400204,236,5,241,29.2831105711,70.7168894289,823
400206,63,35,98,10.8407079646,89.1592920354,904
400207,62,25,87,17.296222664,82.703777336,503
400419,53,10,63,10.3448275862,89.6551724138,609
400415,67,4,71,16.3218390805,83.6781609195,435
400414,154,36,190,18.981018981,81.018981019,1001
400417,242,23,265,26.9857433809,73.0142566191,982
400416,186,13,199,23.6342042755,76.3657957245,842
400411,63,5,68,15.4897494305,84.5102505695,439
400253,193,12,205,21.0256410256,78.9743589744,975
400343,79,67,146,14.6881287726,85.3118712274,994
412295,12,16,28,15.8192090395,84.1807909605,177
400288,39,19,58,7.6821192053,92.3178807947,755
400251,222,7,229,27.0047169811,72.9952830189,848
412405,1,6,7,8.64197530864,91.3580246914,81
412404,10,2,12,15.7894736842,84.2105263158,76
400257,237,2,239,35.5654761905,64.4345238095,672
412407,30,3,33,41.25,58.75,80
400114,285,4,289,37.3868046572,62.6131953428,773
400115,97,20,117,11.8661257606,88.1338742394,986
400116,91,89,180,18.1086519115,81.8913480885,994
412406,3,3,6,7.40740740741,92.5925925926,81
400110,235,18,253,26.6877637131,73.3122362869,948
400111,216,17,233,30.0257731959,69.9742268041,776
412498,7,1,8,15.3846153846,84.6153846154,52
412499,1,0,1,2.17391304348,97.8260869565,46
412497,20,2,22,36.6666666667,63.3333333333,60
412319,10,4,14,7.90960451977,92.0903954802,177
412252,10,10,20,8.19672131148,91.8032786885,244
412253,16,7,23,9.87124463519,90.1287553648,233
412254,11,8,19,8.18965517241,91.8103448276,232
412255,34,1,35,16.2790697674,83.7209302326,215
412256,12,0,12,5.45454545455,94.5454545455,220
412311,17,0,17,9.65909090909,90.3409090909,176
412259,9,6,15,7.89473684211,92.1052631579,190
412315,23,7,30,17.3410404624,82.6589595376,173
412314,23,0,23,13.9393939394,86.0606060606,165
400291,230,17,247,25.6756756757,74.3243243243,962
400290,156,10,166,28.0879864636,71.9120135364,591
400060,36,4,40,7.8431372549,92.1568627451,510
400061,75,3,78,15.234375,84.765625,512
400062,173,6,179,28.2780410742,71.7219589258,633
400063,124,10,134,22.4080267559,77.5919732441,598
412401,2,2,4,4.93827160494,95.0617283951,81
412400,1,1,2,2.43902439024,97.5609756098,82
412403,0,1,1,1.23456790123,98.7654320988,81
412402,3,0,3,3.65853658537,96.3414634146,82
400068,31,9,40,9.43396226415,90.5660377358,424
412409,2,2,4,4.87804878049,95.1219512195,82
412408,3,1,4,4.87804878049,95.1219512195,82
400151,18,8,26,6.03248259861,93.9675174014,431
412458,3,1,4,5.19480519481,94.8051948052,77
412452,2,3,5,6.25,93.75,80
412453,3,7,10,12.1951219512,87.8048780488,82
412466,2,2,4,4.93827160494,95.0617283951,81
400367,30,25,55,8.16023738872,91.8397626113,674
400366,205,24,229,23.7305699482,76.2694300518,965
400365,67,116,183,18.4661957619,81.5338042381,991
400364,223,5,228,26.4808362369,73.5191637631,861
400363,106,4,110,25.3456221198,74.6543778802,434
400249,111,7,118,24.8945147679,75.1054852321,474
400361,116,5,121,23.4042553191,76.5957446809,517
400360,110,3,113,18.7707641196,81.2292358804,602
400244,71,32,103,13.0050505051,86.9949494949,792
400245,177,7,184,24.0522875817,75.9477124183,765
400246,257,12,269,27.3652085453,72.6347914547,983
400247,56,23,79,9.887359199,90.112640801,799
400240,184,28,212,22.6737967914,77.3262032086,935
412454,0,2,2,2.5974025974,97.4025974026,77
412411,0,1,1,1.25,98.75,80
400129,221,10,231,27.4673008323,72.5326991677,841
400093,138,4,142,21.2893553223,78.7106446777,667
400097,136,3,139,27.1484375,72.8515625,512
412214,20,6,26,9.05923344948,90.9407665505,287
412215,8,10,18,6.71641791045,93.2835820896,268
412216,22,7,29,10.9848484848,89.0151515152,264
412309,22,7,29,16.384180791,83.615819209,177
412476,1,0,1,1.23456790123,98.7654320988,81
412211,7,6,13,4.60992907801,95.390070922,282
412212,14,5,19,6.71378091873,93.2862190813,283
412213,23,2,25,13.2275132275,86.7724867725,189
412199,7,7,14,5.20446096654,94.7955390335,269
400392,34,6,40,8.84955752212,91.1504424779,452
412196,58,2,60,21.2014134276,78.7985865724,283
412195,14,2,16,5.81818181818,94.1818181818,275
412194,19,7,26,9.28571428571,90.7142857143,280
412193,10,8,18,6.36042402827,93.6395759717,283
412192,23,2,25,9.09090909091,90.9090909091,275
412191,27,5,32,11.3475177305,88.6524822695,282
412190,41,0,41,14.4876325088,85.5123674912,283
400121,64,22,86,12.8166915052,87.1833084948,671
400289,183,18,201,23.9856801909,76.0143198091,838
400124,219,8,227,26.9596199525,73.0403800475,842
400024,191,5,196,32.9966329966,67.0033670034,594
400025,204,13,217,23.3082706767,76.6917293233,931
400027,61,16,77,12.6229508197,87.3770491803,610
400021,163,10,173,21.0206561361,78.9793438639,823
400029,33,8,41,9.83213429257,90.1678657074,417
412449,3,0,3,3.75,96.25,80
400147,65,8,73,16.9373549884,83.0626450116,431
412440,9,1,10,12.3456790123,87.6543209877,81
400145,30,22,52,11.8721461187,88.1278538813,438
400144,129,13,142,14.7609147609,85.2390852391,962
412445,1,0,1,1.25,98.75,80
400142,59,18,77,9.93548387097,90.064516129,775
412447,0,0,0,0.0,100.0,79
400140,159,21,180,18.5950413223,81.4049586777,968
412500,0,1,1,2.22222222222,97.7777777778,45
412501,4,0,4,14.8148148148,85.1851851852,27
412502,4,0,4,36.3636363636,63.6363636364,11
400321,71,9,80,15.8102766798,84.1897233202,506
400320,35,28,63,9.33333333333,90.6666666667,675
400326,231,12,243,26.9102990033,73.0897009967,903
400657,91,14,105,29.0858725762,70.9141274238,361
400656,24,7,31,9.06432748538,90.9356725146,342
400655,25,3,28,7.8431372549,92.1568627451,357
400654,47,3,50,13.9275766017,86.0724233983,359
400653,54,5,59,16.3888888889,83.6111111111,360
400652,33,9,42,11.9318181818,88.0681818182,352
400651,40,9,49,14.2028985507,85.7971014493,345
400198,180,8,188,26.404494382,73.595505618,712
412209,18,6,24,8.60215053763,91.3978494624,279
400659,34,3,37,10.9792284866,89.0207715134,337
400199,240,4,244,32.3607427056,67.6392572944,754
400211,241,29,270,28.2131661442,71.7868338558,957
412398,1,7,8,9.87654320988,90.1234567901,81
400216,253,21,274,27.3180458624,72.6819541376,1003
412393,5,1,6,6.66666666667,93.3333333333,90
412392,3,2,5,5.68181818182,94.3181818182,88
412395,1,5,6,7.31707317073,92.6829268293,82
412394,4,1,5,6.17283950617,93.8271604938,81
412397,1,2,3,3.65853658537,96.3414634146,82
412396,15,1,16,20.253164557,79.746835443,79
412399,1,5,6,7.40740740741,92.5925925926,81
400195,132,2,134,26.326129666,73.673870334,509
400196,39,2,41,8.28282828283,91.7171717172,495
400219,86,30,116,13.7278106509,86.2721893491,845
400218,194,7,201,29.5154185022,70.4845814978,681
400356,188,10,198,29.9093655589,70.0906344411,662
400355,69,3,72,17.1021377672,82.8978622328,421
400352,91,3,94,21.6091954023,78.3908045977,435
400350,183,18,201,25.5076142132,74.4923857868,788
400351,28,21,49,8.19397993311,91.8060200669,598
400422,161,34,195,21.6426193119,78.3573806881,901
400424,194,13,207,24.2388758782,75.7611241218,854
400425,191,22,213,22.8540772532,77.1459227468,932
400103,235,18,253,26.603575184,73.396424816,951
400101,158,3,161,23.8872403561,76.1127596439,674
412327,7,5,12,6.93641618497,93.063583815,173
412489,3,2,5,6.25,93.75,80
412488,1,0,1,1.25,98.75,80
412485,1,4,5,6.17283950617,93.8271604938,81
412484,1,3,4,5.0,95.0,80
400109,275,7,282,28.9527720739,71.0472279261,974
400108,63,6,69,16.2352941176,83.7647058824,425
412481,2,1,3,3.65853658537,96.3414634146,82
412480,1,1,2,2.46913580247,97.5308641975,81
412483,0,5,5,6.17283950617,93.8271604938,81
412482,0,1,1,1.23456790123,98.7654320988,81
412416,2,3,5,6.09756097561,93.9024390244,82
400057,77,10,87,10.223266745,89.776733255,851
412430,1,1,2,2.46913580247,97.5308641975,81
412431,0,3,3,3.7037037037,96.2962962963,81
412432,12,1,13,16.6666666667,83.3333333333,78
400175,23,17,40,9.1533180778,90.8466819222,437
412434,1,6,7,8.53658536585,91.4634146341,82
412435,15,1,16,19.512195122,80.487804878,82
400170,186,7,193,24.3073047859,75.6926952141,794
400171,33,15,48,6.20957309185,93.7904269082,773
412438,0,19,19,23.75,76.25,80
400076,106,45,151,15.5670103093,84.4329896907,970
400075,235,9,244,28.7735849057,71.2264150943,848
400074,109,7,116,23.7704918033,76.2295081967,488
400178,177,13,190,22.5118483412,77.4881516588,844
400179,211,4,215,32.9754601227,67.0245398773,652
400618,81,14,95,26.7605633803,73.2394366197,355
400617,38,4,42,11.7647058824,88.2352941176,357
400616,51,5,56,15.3005464481,84.6994535519,366
400313,29,8,37,10.9467455621,89.0532544379,338
400259,112,6,118,23.2283464567,76.7716535433,508
400311,21,201,222,36.4532019704,63.5467980296,609
400316,354,68,422,44.7983014862,55.2016985138,942
400314,206,14,220,27.2614622057,72.7385377943,807
400315,28,10,38,7.55467196819,92.4453280318,503
412294,16,6,22,12.5714285714,87.4285714286,175
400252,71,36,107,12.4708624709,87.5291375291,858
400318,107,77,184,18.4738955823,81.5261044177,996
412290,26,0,26,14.606741573,85.393258427,178
412292,14,0,14,7.95454545455,92.0454545455,176
412293,8,4,12,6.89655172414,93.1034482759,174
412474,0,6,6,7.31707317073,92.6829268293,82
412429,1,8,9,10.9756097561,89.0243902439,82
412475,3,1,4,5.06329113924,94.9367088608,79
412428,3,1,4,4.87804878049,95.1219512195,82
400663,34,4,38,10.6741573034,89.3258426966,356
400660,64,5,69,20.0,80.0,345
400661,37,12,49,14.0804597701,85.9195402299,348
412477,1,0,1,1.21951219512,98.7804878049,82
412426,0,1,1,1.23456790123,98.7654320988,81
412471,0,3,3,3.65853658537,96.3414634146,82
412423,3,3,6,7.40740740741,92.5925925926,81
412202,33,0,33,11.8279569892,88.1720430108,279
412200,8,8,16,5.71428571429,94.2857142857,280
412421,0,2,2,2.53164556962,97.4683544304,79
412205,40,38,78,27.2727272727,72.7272727273,286
400227,142,42,184,27.2592592593,72.7407407407,675
400224,41,4,45,10.2505694761,89.7494305239,439
412208,14,6,20,7.27272727273,92.7272727273,275
400220,19,14,33,7.53424657534,92.4657534247,438
400221,52,24,76,8.95170789164,91.0482921084,849
400388,104,63,167,16.9371196755,83.0628803245,986
400381,138,12,150,15.3531218014,84.6468781986,977
400380,198,42,240,24.4399185336,75.5600814664,982
400387,154,37,191,20.9659714599,79.0340285401,911
400033,181,9,190,28.0235988201,71.9764011799,678
400032,27,7,34,7.87037037037,92.1296296296,432
400031,101,9,110,25.3456221198,74.6543778802,434
400030,330,15,345,40.8284023669,59.1715976331,845
412470,10,3,13,16.049382716,83.950617284,81
400036,68,27,95,11.0851808635,88.9148191365,857
412472,1,7,8,10.0,90.0,80
412473,1,6,7,8.53658536585,91.4634146341,82
400039,67,13,80,12.9449838188,87.0550161812,618
400038,39,7,46,10.7476635514,89.2523364486,428
412478,3,1,4,4.87804878049,95.1219512195,82
412479,1,4,5,6.09756097561,93.9024390244,82
412275,12,7,19,10.7344632768,89.2655367232,177
412272,18,6,24,13.5593220339,86.4406779661,177
412379,13,5,18,12.2448979592,87.7551020408,147
412270,12,3,15,8.42696629213,91.5730337079,178
412271,19,4,23,13.0681818182,86.9318181818,176
400133,166,20,186,22.7662178703,77.2337821297,817
400130,193,6,199,26.9647696477,73.0352303523,738
400137,39,9,48,9.73630831643,90.2636916836,493
400134,14,70,84,16.5354330709,83.4645669291,508
400100,176,52,228,23.6269430052,76.3730569948,965
412420,1,5,6,7.59493670886,92.4050632911,79
400090,203,6,209,29.6033994334,70.3966005666,706
412278,23,0,23,13.2183908046,86.7816091954,174
412487,0,1,1,1.25,98.75,80
400046,27,13,40,5.96125186289,94.0387481371,671
400047,148,5,153,24.8780487805,75.1219512195,615
412486,2,2,4,4.87804878049,95.1219512195,82
400042,259,7,266,39.88005997,60.11994003,667
400048,232,12,244,29.3622141998,70.6377858002,831
412010,47,1,48,14.4144144144,85.5855855856,333
412011,18,11,29,9.66666666667,90.3333333333,300
400622,27,10,37,10.7558139535,89.2441860465,344
400623,48,1,49,13.7640449438,86.2359550562,356
400626,26,9,35,9.74930362117,90.2506963788,359
400627,26,6,32,9.27536231884,90.7246376812,345
400628,82,15,97,26.7217630854,73.2782369146,363
412217,33,1,34,11.8881118881,88.1118881119,286
400262,152,24,176,18.5263157895,81.4736842105,950
400263,156,7,163,23.4870317003,76.5129682997,694
400189,262,4,266,26.8686868687,73.1313131313,990
400266,289,26,315,45.7848837209,54.2151162791,688
400267,63,18,81,9.46261682243,90.5373831776,856
400183,329,19,348,40.4651162791,59.5348837209,860
400185,92,7,99,19.9596774194,80.0403225806,496
400184,138,6,144,23.7232289951,76.2767710049,607
400436,169,23,192,22.695035461,77.304964539,846
400435,181,24,205,20.5823293173,79.4176706827,996
400433,38,15,53,11.2288135593,88.7711864407,472
400348,39,83,122,14.2857142857,85.7142857143,854
400431,57,22,79,10.3403141361,89.6596858639,764
400345,209,17,226,44.2270058708,55.7729941292,511
400344,183,24,207,21.835443038,78.164556962,948
400347,216,10,226,26.4018691589,73.5981308411,856
400346,201,3,204,30.3120356612,69.6879643388,673
400341,58,7,65,14.8401826484,85.1598173516,438
400340,145,19,164,16.5489404642,83.4510595358,991
400439,159,18,177,19.3020719738,80.6979280262,917
400342,61,6,67,13.2411067194,86.7588932806,506
400310,222,14,236,25.6800870511,74.3199129489,919
412331,22,4,26,15.7575757576,84.2424242424,165
412239,12,10,22,7.8853046595,92.1146953405,279
412231,43,23,66,23.0769230769,76.9230769231,286
412236,9,8,17,6.00706713781,93.9929328622,283
400165,156,90,246,25.1533742331,74.8466257669,978
400008,240,27,267,29.3729372937,70.6270627063,909
400009,147,4,151,27.962962963,72.037037037,540
400160,264,9,273,32.6555023923,67.3444976077,836
400163,192,14,206,25.6218905473,74.3781094527,804
400162,51,10,61,13.9588100686,86.0411899314,437
412427,1,2,3,3.65853658537,96.3414634146,82
400003,233,10,243,26.4130434783,73.5869565217,920
412424,0,8,8,9.87654320988,90.1234567901,81
400006,39,28,67,15.5452436195,84.4547563805,431
412422,0,4,4,4.87804878049,95.1219512195,82
400004,47,25,72,10.5571847507,89.4428152493,682
400005,36,19,55,11.0220440882,88.9779559118,499
400378,211,19,230,24.3128964059,75.6871035941,946
