,Test Errors,Test Error Rate,Test False Positives,Train Accuracy,Train Size,Test Size,Test Accuracy,Test False Negatives
400301,209,22.5215517241,14,0.779621945597,2169,928,77.4784482759,195
400309,146,21.5022091311,73,0.787436548223,1576,679,78.4977908689,73
400308,218,21.9536757301,71,0.741476046612,2317,993,78.0463242699,147
412281,20,11.4285714286,5,0.881773399015,406,175,88.5714285714,15
412280,19,10.7954545455,3,0.90171990172,407,176,89.2045454545,16
412287,31,17.6136363636,30,0.773722627737,411,176,82.3863636364,1
412284,15,8.57142857143,2,0.900243309002,411,175,91.4285714286,13
400570,68,12.1645796064,19,0.883076923077,1300,559,87.8354203936,49
400255,134,25.8687258687,134,0.731829573935,1197,518,74.1312741313,0
412283,17,9.60451977401,2,0.907090464548,409,177,90.395480226,15
412282,30,17.0454545455,7,0.866336633663,404,176,82.9545454545,23
400176,131,13.3130081301,36,0.867757629368,2261,984,86.6869918699,95
412433,4,5.26315789474,4,0.938888888889,180,76,94.7368421053,0
400239,163,16.9614984391,31,0.836771300448,2230,961,83.0385015609,132
400238,198,19.9798183653,54,0.789291882556,2316,991,80.0201816347,144
400235,96,12.3711340206,47,0.880621876735,1801,776,87.6288659794,49
400234,78,9.92366412214,19,0.913114754098,1830,786,90.0763358779,59
400237,139,22.24,19,0.807718348003,1477,625,77.76,120
400230,106,20.703125,51,0.843906510851,1198,512,79.296875,55
400233,145,25.0,46,0.786500366838,1363,580,75.0,99
400232,85,16.6015625,33,0.833053691275,1192,512,83.3984375,52
412436,3,3.65853658537,3,0.973544973545,189,82,96.3414634146,0
400409,200,22.1729490022,59,0.766178554558,2117,902,77.8270509978,141
400406,53,10.5367793241,5,0.882253994954,1189,503,89.4632206759,48
400407,164,23.9766081871,8,0.760226557583,1589,684,76.0233918129,156
400404,64,8.14249363868,23,0.915207877462,1828,786,91.8575063613,41
412437,6,7.5,6,0.941489361702,188,80,92.5,0
400402,201,24.1007194245,73,0.78575116159,1937,834,75.8992805755,128
400403,137,22.7574750831,40,0.774946921444,1413,602,77.2425249169,97
400400,80,13.1147540984,22,0.883934890304,1413,610,86.8852459016,58
400077,54,12.5581395349,11,0.896449704142,1014,430,87.4418604651,43
412463,1,1.21951219512,1,0.989473684211,190,82,98.7804878049,0
412462,1,1.21951219512,1,0.978723404255,188,82,98.7804878049,0
412461,0,0.0,0,0.983333333333,180,77,100.0,0
412460,2,2.43902439024,2,0.989473684211,190,82,97.5609756098,0
400071,79,11.3997113997,54,0.871826625387,1615,693,88.6002886003,25
412465,1,1.21951219512,1,0.984210526316,190,82,98.7804878049,0
412464,3,3.7037037037,3,0.973544973545,189,81,96.2962962963,0
412469,1,1.23456790123,1,0.978378378378,185,81,98.7654320988,0
412468,1,1.33333333333,1,0.988235294118,170,75,98.6666666667,0
412265,21,11.9318181818,0,0.876237623762,404,176,88.0681818182,21
412308,17,10.0,5,0.90537084399,391,170,90.0,12
400283,186,20.1298701299,85,0.797316057381,2161,924,79.8701298701,101
412261,18,8.78048780488,1,0.89406779661,472,205,91.2195121951,17
400285,71,16.3594470046,18,0.853028798411,1007,434,83.6405529954,53
412263,16,8.16326530612,6,0.940397350993,453,196,91.8367346939,10
412302,18,10.1694915254,1,0.908866995074,406,177,89.8305084746,17
412303,22,12.5,2,0.878345498783,411,176,87.5,20
400122,219,23.2484076433,49,0.779208831647,2174,942,76.7515923567,170
412269,24,13.9534883721,3,0.877805486284,401,172,86.0465116279,21
412307,9,5.1724137931,1,0.924242424242,396,174,94.8275862069,8
412305,25,14.2045454545,9,0.845965770171,409,176,85.7954545455,16
400055,122,12.7882599581,33,0.896162528217,2215,954,87.2117400419,89
412417,4,4.87804878049,4,0.967741935484,186,82,95.1219512195,0
412414,4,4.87804878049,4,0.947368421053,190,82,95.1219512195,0
412415,3,3.65853658537,3,0.984042553191,188,82,96.3414634146,0
412412,11,14.8648648649,0,0.869822485207,169,74,85.1351351351,11
412413,5,6.09756097561,5,0.962962962963,189,82,93.9024390244,0
412410,2,2.43902439024,2,0.968085106383,188,82,97.5609756098,0
400052,55,12.8205128205,18,0.90089197225,1009,429,87.1794871795,37
400058,122,12.9374337222,15,0.842225262198,2193,943,87.0625662778,107
412418,16,19.7530864198,6,0.824468085106,188,81,80.2469135802,10
412419,8,10.2564102564,8,0.872928176796,181,78,89.7435897436,0
412441,2,2.46913580247,2,0.968253968254,189,81,97.5308641975,0
412443,1,1.23456790123,1,0.973404255319,188,81,98.7654320988,0
412442,1,1.28205128205,1,0.973262032086,187,78,98.7179487179,0
412444,2,2.43902439024,2,0.967567567568,185,82,97.5609756098,0
400630,60,16.9014084507,27,0.84147794994,839,355,83.0985915493,33
400141,48,10.9589041096,35,0.889980353635,1018,438,89.0410958904,13
400636,40,11.1111111111,4,0.864406779661,826,360,88.8888888889,36
400639,43,12.3919308357,4,0.871921182266,812,347,87.6080691643,39
400638,54,15.0417827298,38,0.86961722488,836,359,84.9582172702,16
412446,1,1.21951219512,1,0.936842105263,190,82,98.7804878049,0
400271,130,21.4168039539,34,0.750872295883,1433,607,78.5831960461,96
412250,56,19.7879858657,4,0.820276497696,651,283,80.2120141343,52
400273,79,9.3050647821,20,0.900299102692,2006,849,90.6949352179,59
400274,99,22.5512528474,29,0.762596899225,1032,439,77.4487471526,70
400277,50,8.89679715302,12,0.907774390244,1312,562,91.103202847,38
400276,67,15.3318077803,8,0.86243902439,1025,437,84.6681922197,59
400279,42,8.82352941176,16,0.886980108499,1106,476,91.1764705882,26
400278,180,19.0274841438,23,0.792367105861,2201,946,80.9725158562,157
400442,92,23.2911392405,67,0.764705882353,918,395,76.7088607595,25
400379,155,23.413897281,117,0.76447625244,1537,662,76.586102719,38
400440,174,19.5286195286,107,0.816962146622,2087,891,80.4713804714,67
400441,40,9.52380952381,7,0.916241062308,979,420,90.4761904762,33
400371,172,24.9637155298,33,0.746287128713,1616,689,75.0362844702,139
400373,77,11.2573099415,22,0.905354919054,1606,684,88.7426900585,55
400376,77,12.7694859038,10,0.885409252669,1405,603,87.2305140962,67
400297,34,8.25242718447,3,0.913346613546,1004,412,91.7475728155,31
412310,15,8.42696629213,4,0.889975550122,409,178,91.5730337079,11
400082,271,27.4847870183,115,0.755671902269,2292,986,72.5152129817,156
400080,176,19.3406593407,37,0.818352059925,2136,910,80.6593406593,139
400081,149,23.4645669291,73,0.809811827957,1488,635,76.5354330709,76
400086,50,9.80392156863,7,0.897766323024,1164,510,90.1960784314,43
400087,144,23.9202657807,85,0.786897048236,1389,602,76.0797342193,59
400089,44,8.88888888889,12,0.927398444252,1157,495,91.1111111111,32
412317,13,7.30337078652,2,0.862407862408,407,178,92.6966292135,11
412228,15,5.33807829181,4,0.945904173107,647,281,94.6619217082,11
412186,21,7.39436619718,1,0.933125972006,643,284,92.6056338028,20
412221,16,5.81818181818,8,0.948275862069,638,275,94.1818181818,8
412189,19,6.69014084507,6,0.913897280967,662,284,93.3098591549,13
412225,68,24.8175182482,68,0.664556962025,632,274,75.1824817518,0
412226,25,8.86524822695,5,0.881818181818,660,282,91.134751773,20
400280,47,10.7551487414,24,0.8564453125,1024,437,89.2448512586,23
400019,42,7.17948717949,42,0.936390532544,1352,585,92.8205128205,0
400018,142,15.0743099788,39,0.861566484517,2196,942,84.9256900212,103
400152,124,20.6322795341,45,0.8,1385,601,79.3677204659,79
400154,92,10.586881473,25,0.886689757546,2021,869,89.413118527,67
400157,58,8.68263473054,14,0.919007184847,1531,668,91.3173652695,44
400158,58,11.6465863454,10,0.881998277347,1161,498,88.3534136546,48
400010,93,10.9799291617,28,0.898073022312,1972,847,89.0200708383,65
400013,139,22.9372937294,11,0.77240398293,1406,606,77.0627062706,128
412451,3,3.75,3,0.978609625668,187,80,96.25,0
412456,1,1.25,1,0.946808510638,188,80,98.75,0
412457,2,2.46913580247,2,0.978835978836,189,81,97.5308641975,0
400017,113,13.0938586327,48,0.863230921705,2018,863,86.9061413673,65
409888,45,8.94632206759,7,0.900684931507,1168,503,91.0536779324,38
400335,55,10.6796116505,8,0.881130507066,1203,515,89.3203883495,47
400337,154,23.4756097561,72,0.799204771372,1509,656,76.5243902439,82
400331,282,28.5136501517,110,0.74317886531,2309,989,71.4863498483,172
400333,206,22.3185265439,21,0.758991125642,2141,923,77.6814734561,185
400648,68,18.6301369863,17,0.843786982249,845,365,81.3698630137,51
400640,54,15.0837988827,14,0.827878787879,825,358,84.9162011173,40
400641,59,16.6197183099,20,0.876225490196,816,355,83.3802816901,39
400643,29,7.96703296703,5,0.912529550827,846,364,92.032967033,24
400644,33,9.29577464789,10,0.905683192261,827,355,90.7042253521,23
400645,74,21.2034383954,74,0.76690821256,828,349,78.7965616046,0
400646,15,9.61538461538,15,0.918032786885,366,156,90.3846153846,0
400647,40,11.0497237569,11,0.856115107914,834,362,88.9502762431,29
400349,84,19.8581560284,60,0.78125,992,423,80.1418439716,24
412382,16,12.6984126984,2,0.882352941176,289,126,87.3015873016,14
412383,37,28.2442748092,11,0.736842105263,304,131,71.7557251908,26
412386,32,28.8288288288,2,0.75,256,111,71.1711711712,30
412385,7,6.60377358491,0,0.864,250,106,93.3962264151,7
412388,14,12.962962963,12,0.911646586345,249,108,87.037037037,2
412258,10,4.8309178744,2,0.910973084886,483,207,95.1690821256,8
400209,179,23.4293193717,104,0.778905809363,1773,764,76.5706806283,75
400204,204,24.787363305,60,0.772939346812,1929,823,75.212636695,144
400206,100,11.0619469027,37,0.881740775781,2114,904,88.9380530973,63
400207,82,16.3021868787,32,0.81494057725,1178,503,83.6978131213,50
400419,63,10.3448275862,10,0.887154009936,1409,609,89.6551724138,53
400415,69,15.8620689655,5,0.807465618861,1018,435,84.1379310345,64
400414,174,17.3826173826,61,0.82468924132,2333,1001,82.6173826174,113
400417,242,24.6435845214,60,0.772648083624,2296,982,75.3564154786,182
400416,199,23.6342042755,13,0.770010131712,1974,842,76.3657957245,186
400411,68,15.4897494305,5,0.857002938296,1021,439,84.5102505695,63
400253,204,20.9230769231,12,0.798068481124,2278,975,79.0769230769,192
400343,147,14.7887323944,68,0.839030722631,2311,994,85.2112676056,79
412295,29,16.384180791,18,0.878640776699,412,177,83.615819209,11
400288,58,7.6821192053,19,0.91454442558,1767,755,92.3178807947,39
400251,214,25.2358490566,42,0.74706782254,1961,848,74.7641509434,172
412405,9,11.1111111111,9,0.968253968254,189,81,88.8888888889,0
412404,11,14.4736842105,0,0.857954545455,176,76,85.5263157895,11
400257,153,22.7678571429,130,0.751741608613,1579,672,77.2321428571,23
412407,31,38.75,0,0.75,188,80,61.25,31
400114,173,22.3803363519,129,0.763320246775,1783,773,77.6196636481,44
400115,117,11.8661257606,20,0.878133102852,2314,986,88.1338742394,97
400116,180,18.1086519115,89,0.826764833261,2309,994,81.8913480885,91
412406,4,4.93827160494,4,0.962162162162,185,81,95.0617283951,0
400110,242,25.5274261603,42,0.773273942094,2245,948,74.4725738397,200
400111,234,30.1546391753,18,0.727928928373,1801,776,69.8453608247,216
412498,8,15.3846153846,0,0.865546218487,119,52,84.6153846154,8
412499,0,0.0,0,0.990566037736,106,46,100.0,0
412497,18,30.0,3,0.678832116788,137,60,70.0,15
412319,13,7.34463276836,2,0.929440389294,411,177,92.6553672316,11
412252,20,8.19672131148,10,0.88908765653,559,244,91.8032786885,10
412253,21,9.01287553648,5,0.914700544465,551,233,90.9871244635,16
412254,18,7.75862068966,8,0.920903954802,531,232,92.2413793103,10
412255,37,17.2093023256,3,0.841176470588,510,215,82.7906976744,34
412256,12,5.45454545455,1,0.880392156863,510,220,94.5454545455,11
412311,16,9.09090909091,1,0.874384236453,406,176,90.9090909091,15
412259,16,8.42105263158,6,0.923611111111,432,190,91.5789473684,10
412315,26,15.0289017341,8,0.841191066998,403,173,84.9710982659,18
412314,21,12.7272727273,0,0.875,392,165,87.2727272727,21
400291,221,22.972972973,65,0.783699059561,2233,962,77.027027027,156
400290,160,27.0727580372,46,0.782417582418,1365,591,72.9272419628,114
400060,40,7.8431372549,4,0.921434671221,1171,510,92.1568627451,36
400061,63,12.3046875,13,0.873015873016,1197,512,87.6953125,50
400062,148,23.3807266983,48,0.779797979798,1485,633,76.6192733017,100
400063,134,22.4080267559,10,0.778985507246,1380,598,77.5919732441,124
412401,2,2.46913580247,2,0.984042553191,188,81,97.5308641975,0
412400,2,2.43902439024,2,0.983957219251,187,82,97.5609756098,0
412403,3,3.7037037037,3,0.983957219251,187,81,96.2962962963,0
412402,1,1.21951219512,1,0.978947368421,190,82,98.7804878049,0
400068,41,9.66981132075,10,0.912087912088,1001,424,90.3301886792,31
412409,2,2.43902439024,2,0.952127659574,188,82,97.5609756098,0
412408,3,3.65853658537,3,0.926315789474,190,82,96.3414634146,0
400151,26,6.03248259861,8,0.910536779324,1006,431,93.9675174014,18
412458,2,2.5974025974,2,0.983870967742,186,77,97.4025974026,0
412452,3,3.75,3,0.957671957672,189,80,96.25,0
412453,8,9.75609756098,8,0.888888888889,189,82,90.243902439,0
412466,4,4.93827160494,4,0.983870967742,186,81,95.0617283951,0
400367,55,8.16023738872,25,0.909090909091,1584,674,91.8397626113,30
400366,224,23.2124352332,31,0.763402747009,2257,965,76.7875647668,193
400365,183,18.4661957619,116,0.82972270364,2308,991,81.5338042381,67
400364,202,23.4610917538,49,0.756097560976,2009,861,76.5389082462,153
400363,85,19.5852534562,72,0.794896957802,1019,434,80.4147465438,13
400249,106,22.3628691983,20,0.792825112108,1115,474,77.6371308017,86
400361,109,21.083172147,26,0.798994974874,1194,517,78.916827853,83
400360,113,18.7707641196,3,0.782051282051,1404,602,81.2292358804,110
400244,100,12.6262626263,44,0.842219804135,1838,792,87.3737373737,56
400245,184,24.0522875817,7,0.731007315701,1777,765,75.9477124183,177
400246,242,24.6185147508,44,0.778850372971,2279,983,75.3814852492,198
400247,80,10.0125156446,24,0.896367521368,1872,799,89.9874843554,56
400240,212,22.6737967914,28,0.789208962048,2187,935,77.3262032086,184
412454,4,5.19480519481,4,0.951612903226,186,77,94.8051948052,0
412411,1,1.25,1,0.915789473684,190,80,98.75,0
400129,217,25.8026159334,39,0.7424629535,1957,841,74.1973840666,178
400093,143,21.4392803598,13,0.732863549007,1561,667,78.5607196402,130
400097,125,24.4140625,30,0.796822742475,1196,512,75.5859375,95
412214,25,8.71080139373,5,0.909365558912,662,287,91.2891986063,20
412215,18,6.71641791045,10,0.937106918239,636,268,93.2835820896,8
412216,29,10.9848484848,7,0.847058823529,595,264,89.0151515152,22
412309,30,16.9491525424,10,0.87104622871,411,177,83.0508474576,20
412476,2,2.46913580247,2,0.978494623656,186,81,97.5308641975,0
412211,10,3.54609929078,3,0.938461538462,650,282,96.4539007092,7
412212,15,5.30035335689,3,0.953313253012,664,283,94.6996466431,12
412213,24,12.6984126984,3,0.856164383562,438,189,87.3015873016,21
412199,13,4.83271375465,7,0.943925233645,642,269,95.1672862454,6
400392,40,8.84955752212,6,0.914645974782,1031,452,91.1504424779,34
412196,50,17.667844523,11,0.796636085627,654,283,82.332155477,39
412195,17,6.18181818182,2,0.926677067083,641,275,93.8181818182,15
412194,24,8.57142857143,6,0.923896499239,657,280,91.4285714286,18
412193,19,6.71378091873,7,0.918552036199,663,283,93.2862190813,12
412192,25,9.09090909091,2,0.908809891808,647,275,90.9090909091,23
412191,33,11.7021276596,4,0.907153729072,657,282,88.2978723404,29
412190,42,14.8409893993,0,0.871913580247,648,283,85.1590106007,42
400121,86,12.8166915052,22,0.873497786211,1581,671,87.1833084948,64
400289,202,24.1050119332,19,0.76557711951,1958,838,75.8949880668,183
400124,234,27.7909738717,43,0.738976178409,1973,842,72.2090261283,191
400024,128,21.5488215488,72,0.797258297258,1386,594,78.4511784512,56
400025,222,23.8453276047,50,0.778548312529,2163,931,76.1546723953,172
400027,78,12.7868852459,17,0.871650211566,1418,610,87.2131147541,61
400021,173,21.0206561361,10,0.764613778706,1916,823,78.9793438639,163
400029,41,9.83213429257,8,0.901740020471,977,417,90.1678657074,33
412449,2,2.5,2,0.973404255319,188,80,97.5,0
400147,72,16.7053364269,27,0.85093780849,1013,431,83.2946635731,45
412440,9,11.1111111111,0,0.882352941176,187,81,88.8888888889,9
400145,51,11.6438356164,22,0.898821218075,1018,438,88.3561643836,29
400144,143,14.8648648649,14,0.852068345324,2224,962,85.1351351351,129
412445,0,0.0,0,0.967741935484,186,80,100.0,0
400142,77,9.93548387097,18,0.877337733773,1818,775,90.064516129,59
412447,0,0.0,0,0.957219251337,187,79,100.0,0
400140,179,18.4917355372,21,0.783496007098,2254,968,81.5082644628,158
412500,2,4.44444444444,2,0.971428571429,105,45,95.5555555556,0
412501,4,14.8148148148,0,0.854838709677,62,27,85.1851851852,4
412502,4,36.3636363636,0,0.84,25,11,63.6363636364,4
400321,82,16.2055335968,24,0.857747671465,1181,506,83.7944664032,58
400320,63,9.33333333333,28,0.906918238994,1590,675,90.6666666667,35
400326,159,17.6079734219,60,0.827915869981,2092,903,82.3920265781,99
400657,73,20.2216066482,42,0.839667458432,842,361,79.7783933518,31
400656,31,9.06432748538,7,0.896815286624,785,342,90.9356725146,24
400655,28,7.8431372549,3,0.894357743097,833,357,92.1568627451,25
400654,50,13.9275766017,3,0.882211538462,832,359,86.0724233983,47
400653,59,16.3888888889,5,0.851674641148,836,360,83.6111111111,54
400652,43,12.2159090909,10,0.897218863362,827,352,87.7840909091,33
400651,48,13.9130434783,9,0.863463969659,791,345,86.0869565217,39
400198,188,26.404494382,8,0.754626865672,1675,712,73.595505618,180
412209,25,8.9605734767,10,0.926717557252,655,279,91.0394265233,15
400659,38,11.2759643917,4,0.884223918575,786,337,88.7240356083,34
400199,211,27.9840848806,54,0.743618831537,1763,754,72.0159151194,157
400211,252,26.3322884013,60,0.733936651584,2210,957,73.6677115987,192
412398,9,11.1111111111,9,0.94708994709,189,81,88.8888888889,0
400216,219,21.8344965105,84,0.789383561644,2336,1003,78.1655034895,135
412393,3,3.33333333333,1,0.966666666667,210,90,96.6666666667,2
412392,5,5.68181818182,3,0.92270531401,207,88,94.3181818182,2
412395,7,8.53658536585,7,0.920634920635,189,82,91.4634146341,0
412394,1,1.23456790123,1,0.968085106383,188,81,98.7654320988,0
412397,5,6.09756097561,5,0.951086956522,184,82,93.9024390244,0
412396,18,22.7848101266,4,0.75,184,79,77.2151898734,14
412399,5,6.17283950617,5,0.872340425532,188,81,93.8271604938,0
400195,107,21.021611002,65,0.812234494477,1177,509,78.978388998,42
400196,41,8.28282828283,2,0.9165232358,1162,495,91.7171717172,39
400219,114,13.4911242604,46,0.860913705584,1970,845,86.5088757396,68
400218,167,24.5227606461,52,0.732958098812,1599,681,75.4772393539,115
400356,138,20.8459214502,47,0.766645119586,1547,662,79.1540785498,91
400355,71,16.864608076,3,0.823350253807,985,421,83.135391924,68
400352,85,19.5402298851,24,0.851231527094,1015,435,80.4597701149,61
400350,201,25.5076142132,18,0.747954173486,1833,788,74.4923857868,183
400351,50,8.36120401338,22,0.889605734767,1395,598,91.6387959866,28
400422,194,21.5316315205,34,0.783731125183,2053,901,78.4683684795,160
400424,208,24.355971897,14,0.774387193597,1999,854,75.644028103,194
400425,213,22.8540772532,22,0.782350251486,2187,932,77.1459227468,191
400103,224,23.5541535226,50,0.783116299955,2227,951,76.4458464774,174
400101,162,24.0356083086,36,0.747455470738,1572,674,75.9643916914,126
412327,10,5.78034682081,2,0.925187032419,401,173,94.2196531792,8
412489,2,2.5,2,0.96256684492,187,80,97.5,0
412488,0,0.0,0,0.973404255319,188,80,100.0,0
412485,5,6.17283950617,5,0.913978494624,186,81,93.8271604938,0
412484,5,6.25,5,0.968085106383,188,80,93.75,0
400109,175,17.9671457906,61,0.803271441202,2262,974,82.0328542094,114
400108,62,14.5882352941,16,0.848024316109,987,425,85.4117647059,46
412481,4,4.87804878049,4,0.968085106383,188,82,95.1219512195,0
412480,1,1.23456790123,1,0.962365591398,186,81,98.7654320988,0
412483,7,8.64197530864,7,0.957894736842,190,81,91.3580246914,0
412482,3,3.7037037037,3,0.973684210526,190,81,96.2962962963,0
412416,3,3.65853658537,3,0.935483870968,186,82,96.3414634146,0
400057,87,10.223266745,10,0.893509127789,1972,851,89.776733255,77
412430,3,3.7037037037,3,0.952380952381,189,81,96.2962962963,0
412431,4,4.93827160494,4,0.962962962963,189,81,95.0617283951,0
412432,14,17.9487179487,0,0.837837837838,185,78,82.0512820513,14
400175,40,9.1533180778,17,0.906496062992,1016,437,90.8466819222,23
412434,8,9.75609756098,8,0.92513368984,187,82,90.243902439,0
412435,16,19.512195122,0,0.830687830688,189,82,80.487804878,16
400170,191,24.0554156171,7,0.758003255562,1843,794,75.9445843829,184
400171,49,6.33893919793,16,0.921360847741,1793,773,93.6610608021,33
412438,20,25.0,16,0.755319148936,188,80,75.0,4
400076,151,15.5670103093,45,0.850589777195,2289,970,84.4329896907,106
400075,197,23.2311320755,47,0.769889224572,1986,848,76.7688679245,150
400074,122,25.0,27,0.792402826855,1132,488,75.0,95
400178,190,22.5118483412,13,0.762982005141,1945,844,77.4881516588,177
400179,120,18.4049079755,70,0.78740690589,1477,652,81.5950920245,50
400618,95,26.7605633803,95,0.767639902676,822,355,73.2394366197,0
400617,42,11.7647058824,4,0.877551020408,833,357,88.2352941176,38
400616,65,17.7595628415,52,0.825775656325,838,366,82.2404371585,13
400313,37,10.9467455621,8,0.909319899244,794,338,89.0532544379,29
400259,117,23.031496063,17,0.791912384162,1187,508,76.968503937,100
400311,152,24.9589490969,92,0.776504297994,1396,609,75.0410509031,60
400316,298,31.6348195329,298,0.681014952424,2207,942,68.3651804671,0
400314,220,27.2614622057,39,0.733048585158,1873,807,72.7385377943,181
400315,38,7.55467196819,10,0.905090595341,1159,503,92.4453280318,28
412294,22,12.5714285714,6,0.881481481481,405,175,87.4285714286,16
400252,109,12.703962704,38,0.888554216867,1992,858,87.296037296,71
400318,184,18.4738955823,77,0.815517241379,2320,996,81.5261044177,107
412290,26,14.606741573,1,0.835351089588,413,178,85.393258427,25
412292,13,7.38636363636,1,0.890510948905,411,176,92.6136363636,12
412293,11,6.32183908046,2,0.917274939173,411,174,93.6781609195,9
412474,9,10.9756097561,9,0.873015873016,189,82,89.0243902439,0
412429,9,10.9756097561,9,0.883597883598,189,82,89.0243902439,0
412475,1,1.26582278481,1,0.957219251337,187,79,98.7341772152,0
412428,2,2.43902439024,2,0.989473684211,190,82,97.5609756098,0
400663,38,10.6741573034,4,0.870967741935,837,356,89.3258426966,34
400660,53,15.3623188406,19,0.812958435208,818,345,84.6376811594,34
400661,49,14.0804597701,12,0.885225885226,819,348,85.9195402299,37
412477,3,3.65853658537,3,0.931216931217,189,82,96.3414634146,0
412426,1,1.23456790123,1,0.957219251337,187,81,98.7654320988,0
412471,4,4.87804878049,4,0.941798941799,189,82,95.1219512195,0
412423,3,3.7037037037,3,0.957894736842,190,81,96.2962962963,0
412202,34,12.1863799283,0,0.856488549618,655,279,87.8136200717,34
412200,15,5.35714285714,7,0.940345368917,637,280,94.6428571429,8
412421,2,2.53164556962,2,0.978494623656,186,79,97.4683544304,0
412205,74,25.8741258741,74,0.763554216867,664,286,74.1258741259,0
400227,184,27.2592592593,42,0.741671904463,1591,675,72.7407407407,142
400224,46,10.4783599089,5,0.912023460411,1023,439,89.5216400911,41
412208,19,6.90909090909,6,0.927215189873,632,275,93.0909090909,13
400220,33,7.53424657534,14,0.904150197628,1012,438,92.4657534247,19
400221,77,9.06949352179,25,0.897371081901,1978,849,90.9305064782,52
400388,167,16.9371196755,63,0.82125813449,2305,986,83.0628803245,104
400381,150,15.3531218014,12,0.849955869373,2266,977,84.6468781986,138
400380,182,18.533604888,123,0.818853171156,2302,982,81.466395112,59
400387,191,20.9659714599,37,0.805268109125,2126,911,79.0340285401,154
400033,184,27.1386430678,28,0.728070175439,1596,678,72.8613569322,156
400032,34,7.87037037037,7,0.91707798618,1013,432,92.1296296296,27
400031,103,23.732718894,21,0.817288801572,1018,434,76.267281106,82
400030,208,24.6153846154,205,0.742973939704,1957,845,75.3846153846,3
412470,12,14.8148148148,0,0.843243243243,185,81,85.1851851852,12
400036,96,11.2018669778,28,0.881822734101,1997,857,88.7981330222,68
412472,9,11.25,9,0.904761904762,189,80,88.75,0
412473,6,7.31707317073,6,0.915789473684,190,82,92.6829268293,0
400039,74,11.9741100324,25,0.893442622951,1464,618,88.0258899676,49
400038,46,10.7476635514,7,0.9037111334,997,428,89.2523364486,39
412478,2,2.43902439024,2,0.967391304348,184,82,97.5609756098,0
412479,5,6.09756097561,5,0.973262032086,187,82,93.9024390244,0
412275,21,11.8644067797,8,0.884803921569,408,177,88.1355932203,13
412272,24,13.5593220339,5,0.877750611247,409,177,86.4406779661,19
412379,14,9.52380952381,2,0.933933933934,333,147,90.4761904762,12
412270,21,11.797752809,7,0.891358024691,405,178,88.202247191,14
412271,21,11.9318181818,4,0.890510948905,411,176,88.0681818182,17
400133,186,22.7662178703,20,0.781153450051,1942,817,77.2337821297,166
400130,197,26.6937669377,42,0.744334689134,1721,738,73.3062330623,155
400137,48,9.73630831643,9,0.890434782609,1150,493,90.2636916836,39
400134,84,16.5354330709,70,0.813675213675,1170,508,83.4645669291,14
400100,227,23.5233160622,52,0.747111111111,2250,965,76.4766839378,175
412420,6,7.59493670886,6,0.924731182796,186,79,92.4050632911,0
400090,200,28.328611898,47,0.754247572816,1648,706,71.671388102,153
412278,22,12.6436781609,0,0.911764705882,408,174,87.3563218391,22
412487,3,3.75,3,0.936842105263,190,80,96.25,0
400046,40,5.96125186289,13,0.904153354633,1565,671,94.0387481371,27
400047,132,21.4634146341,51,0.792767732962,1438,615,78.5365853659,81
412486,4,4.87804878049,4,0.967914438503,187,82,95.1219512195,0
400042,159,23.8380809595,122,0.772208121827,1576,667,76.1619190405,37
400048,202,24.3080625752,59,0.767987486966,1918,831,75.6919374248,143
412010,48,14.4144144144,1,0.87146529563,778,333,85.5855855856,47
412011,29,9.66666666667,11,0.88293370945,709,300,90.3333333333,18
400622,37,10.7558139535,10,0.886956521739,805,344,89.2441860465,27
400623,46,12.9213483146,2,0.884662576687,815,356,87.0786516854,44
400626,35,9.74930362117,9,0.913461538462,832,359,90.2506963788,26
400627,32,9.27536231884,6,0.899378881988,805,345,90.7246376812,26
400628,68,18.7327823691,63,0.825829383886,844,363,81.2672176309,5
412217,32,11.1888111888,0,0.871406959153,661,286,88.8111888112,32
400262,176,18.5263157895,24,0.814649397052,2239,950,81.4736842105,152
400263,166,23.9193083573,38,0.752481389578,1612,694,76.0806916427,128
400189,194,19.595959596,66,0.819956616052,2305,990,80.404040404,128
400266,207,30.0872093023,207,0.720376175549,1595,688,69.9127906977,0
400267,82,9.57943925234,19,0.902756892231,1995,856,90.4205607477,63
400183,208,24.1860465116,168,0.746365914787,1995,860,75.8139534884,40
400185,99,19.9596774194,7,0.800515907137,1163,496,80.0403225806,92
400184,133,21.9110378913,22,0.743824982357,1417,607,78.0889621087,111
400436,192,22.695035461,23,0.755973563803,1967,846,77.304964539,169
400435,158,15.8634538153,75,0.845161290323,2325,996,84.1365461847,83
400433,53,11.2288135593,15,0.908265213442,1101,472,88.7711864407,38
400348,122,14.2857142857,83,0.861686017163,1981,854,85.7142857143,39
400431,80,10.4712041885,28,0.89420935412,1796,764,89.5287958115,52
400345,141,27.5929549902,141,0.744556113903,1194,511,72.4070450098,0
400344,156,16.4556962025,62,0.842129003157,2217,948,83.5443037975,94
400347,226,26.4018691589,10,0.759697732997,1985,856,73.5981308411,216
400346,146,21.6939078752,45,0.772959183673,1568,673,78.3060921248,101
400341,65,14.8401826484,7,0.875,1024,438,85.1598173516,58
400340,164,16.5489404642,19,0.826030368764,2305,991,83.4510595358,145
400439,166,18.1025081788,49,0.832258064516,2170,917,81.8974918212,117
400342,67,13.2411067194,6,0.896872358411,1183,506,86.7588932806,61
400310,221,24.0478781284,59,0.760484622554,2146,919,75.9521218716,162
412331,25,15.1515151515,2,0.878706199461,371,165,84.8484848485,23
412239,21,7.52688172043,9,0.922018348624,654,279,92.4731182796,12
412231,49,17.1328671329,38,0.809022556391,665,286,82.8671328671,11
412236,14,4.94699646643,6,0.944358578053,647,283,95.0530035336,8
400165,215,21.9836400818,172,0.784837861525,2282,978,78.0163599182,43
400008,228,25.0825082508,69,0.769230769231,2145,909,74.9174917492,159
400009,126,23.3333333333,99,0.77874702617,1261,540,76.6666666667,27
400160,189,22.6076555024,72,0.768280123584,1942,836,77.3923444976,117
400163,206,25.6218905473,14,0.747340425532,1880,804,74.3781094527,192
400162,61,13.9588100686,10,0.848574237955,1017,437,86.0411899314,51
412427,2,2.43902439024,2,0.968253968254,189,82,97.5609756098,0
400003,220,23.9130434783,43,0.778908418131,2162,920,76.0869565217,177
412424,9,11.1111111111,9,0.89010989011,182,81,88.8888888889,0
400006,68,15.777262181,29,0.834160873883,1007,431,84.222737819,39
412422,6,7.31707317073,6,0.952631578947,190,82,92.6829268293,0
400004,71,10.4105571848,25,0.8975,1600,682,89.5894428152,46
400005,55,11.0220440882,19,0.910761154856,1143,499,88.9779559118,36
400378,229,24.2071881607,51,0.788055680287,2227,946,75.7928118393,178
