,Test Errors,Test Error Rate,Test False Positives,Train Accuracy,Train Size,Test Size,Test Accuracy,Test False Negatives
400301,182,19.6120689655,34,0.812355924389,2169,928,80.3879310345,148
400309,138,20.324005891,58,0.81345177665,1576,679,79.675994109,80
400308,203,20.443101712,112,0.812688821752,2317,993,79.556898288,91
412281,20,11.4285714286,5,0.889162561576,406,175,88.5714285714,15
412280,19,10.7954545455,3,0.90171990172,407,176,89.2045454545,16
412287,30,17.0454545455,11,0.849148418491,411,176,82.9545454545,19
412284,14,8.0,1,0.907542579075,411,175,92.0,13
400570,68,12.1645796064,19,0.883076923077,1300,559,87.8354203936,49
400255,125,24.1312741313,115,0.753550543024,1197,518,75.8687258687,10
412283,17,9.60451977401,2,0.919315403423,409,177,90.395480226,15
412282,30,17.0454545455,7,0.866336633663,404,176,82.9545454545,23
400176,131,13.3130081301,36,0.867757629368,2261,984,86.6869918699,95
412433,4,5.26315789474,4,0.938888888889,180,76,94.7368421053,0
400239,140,14.5681581686,61,0.884304932735,2230,961,85.4318418314,79
400238,186,18.7689202825,66,0.839378238342,2316,991,81.2310797175,120
400235,80,10.3092783505,54,0.910605219323,1801,776,89.6907216495,26
400234,77,9.79643765903,19,0.914754098361,1830,786,90.203562341,58
400237,133,21.28,28,0.834123222749,1477,625,78.72,105
400230,92,17.96875,40,0.874791318865,1198,512,82.03125,52
400233,103,17.7586206897,47,0.838591342627,1363,580,82.2413793103,56
400232,88,17.1875,29,0.866610738255,1192,512,82.8125,59
412436,3,3.65853658537,3,0.973544973545,189,82,96.3414634146,0
400409,180,19.955654102,77,0.837505904582,2117,902,80.044345898,103
400406,46,9.14512922465,7,0.896551724138,1189,503,90.8548707753,39
400407,136,19.8830409357,20,0.807426054122,1589,684,80.1169590643,116
400404,65,8.26972010178,25,0.916849015317,1828,786,91.7302798982,40
412437,6,7.5,6,0.941489361702,188,80,92.5,0
400402,182,21.8225419664,85,0.834279814146,1937,834,78.1774580336,97
400403,109,18.1063122924,48,0.842887473461,1413,602,81.8936877076,61
400400,81,13.2786885246,23,0.888181174805,1413,610,86.7213114754,58
400077,54,12.5581395349,14,0.909270216963,1014,430,87.4418604651,40
412463,1,1.21951219512,1,0.989473684211,190,82,98.7804878049,0
412462,1,1.21951219512,1,0.978723404255,188,82,98.7804878049,0
412461,0,0.0,0,0.983333333333,180,77,100.0,0
412460,2,2.43902439024,2,0.989473684211,190,82,97.5609756098,0
400071,78,11.2554112554,54,0.874303405573,1615,693,88.7445887446,24
412465,1,1.21951219512,1,0.984210526316,190,82,98.7804878049,0
412464,3,3.7037037037,3,0.973544973545,189,81,96.2962962963,0
412469,1,1.23456790123,1,0.978378378378,185,81,98.7654320988,0
412468,1,1.33333333333,1,0.988235294118,170,75,98.6666666667,0
412265,20,11.3636363636,0,0.891089108911,404,176,88.6363636364,20
412308,17,10.0,5,0.907928388747,391,170,90.0,12
400283,197,21.3203463203,89,0.827394724665,2161,924,78.6796536797,108
412261,15,7.31707317073,1,0.900423728814,472,205,92.6829268293,14
400285,58,13.3640552995,27,0.900695134062,1007,434,86.6359447005,31
412263,16,8.16326530612,6,0.940397350993,453,196,91.8367346939,10
412302,18,10.1694915254,1,0.908866995074,406,177,89.8305084746,17
412303,22,12.5,2,0.878345498783,411,176,87.5,20
400122,186,19.7452229299,70,0.833026678933,2174,942,80.2547770701,116
412269,24,13.9534883721,3,0.877805486284,401,172,86.0465116279,21
412307,9,5.1724137931,1,0.924242424242,396,174,94.8275862069,8
412305,25,14.2045454545,9,0.845965770171,409,176,85.7954545455,16
400055,122,12.7882599581,33,0.896162528217,2215,954,87.2117400419,89
412417,4,4.87804878049,4,0.967741935484,186,82,95.1219512195,0
412414,4,4.87804878049,4,0.947368421053,190,82,95.1219512195,0
412415,3,3.65853658537,3,0.984042553191,188,82,96.3414634146,0
412412,11,14.8648648649,0,0.869822485207,169,74,85.1351351351,11
412413,5,6.09756097561,5,0.962962962963,189,82,93.9024390244,0
412410,2,2.43902439024,2,0.968085106383,188,82,97.5609756098,0
400052,55,12.8205128205,18,0.90089197225,1009,429,87.1794871795,37
400058,118,12.5132555673,31,0.872777017784,2193,943,87.4867444327,87
412418,15,18.5185185185,5,0.872340425532,188,81,81.4814814815,10
412419,9,11.5384615385,8,0.889502762431,181,78,88.4615384615,1
412441,3,3.7037037037,2,0.978835978836,189,81,96.2962962963,1
412443,1,1.23456790123,1,0.973404255319,188,81,98.7654320988,0
412442,1,1.28205128205,1,0.973262032086,187,78,98.7179487179,0
412444,2,2.43902439024,2,0.967567567568,185,82,97.5609756098,0
400630,58,16.338028169,30,0.896305125149,839,355,83.661971831,28
400141,47,10.7305936073,34,0.89489194499,1018,438,89.2694063927,13
400636,39,10.8333333333,4,0.869249394673,826,360,89.1666666667,35
400639,28,8.06916426513,9,0.905172413793,812,347,91.9308357349,19
400638,34,9.47075208914,15,0.918660287081,836,359,90.5292479109,19
412446,1,1.21951219512,1,0.936842105263,190,82,98.7804878049,0
400271,119,19.6046128501,52,0.824842986741,1433,607,80.3953871499,67
412250,54,19.0812720848,6,0.861751152074,651,283,80.9187279152,48
400273,84,9.89399293286,27,0.902791625125,2006,849,90.1060070671,57
400274,81,18.4510250569,43,0.830426356589,1032,439,81.5489749431,38
400277,50,8.89679715302,12,0.908536585366,1312,562,91.103202847,38
400276,56,12.8146453089,11,0.886829268293,1025,437,87.1853546911,45
400279,42,8.82352941176,16,0.886980108499,1106,476,91.1764705882,26
400278,176,18.6046511628,29,0.807814629714,2201,946,81.3953488372,147
400442,65,16.4556962025,28,0.845315904139,918,395,83.5443037975,37
400379,139,20.996978852,76,0.812621990891,1537,662,79.003021148,63
400440,147,16.4983164983,62,0.860565404887,2087,891,83.5016835017,85
400441,40,9.52380952381,7,0.917262512768,979,420,90.4761904762,33
400371,143,20.7547169811,41,0.824876237624,1616,689,79.2452830189,102
400373,74,10.8187134503,23,0.909713574097,1606,684,89.1812865497,51
400376,76,12.6036484245,10,0.891814946619,1405,603,87.3963515755,66
400297,34,8.25242718447,3,0.913346613546,1004,412,91.7475728155,31
412310,15,8.42696629213,4,0.889975550122,409,178,91.5730337079,11
400082,235,23.8336713996,138,0.804537521815,2292,986,76.1663286004,97
400080,180,19.7802197802,49,0.826779026217,2136,910,80.2197802198,131
400081,126,19.842519685,75,0.851478494624,1488,635,80.157480315,51
400086,49,9.60784313725,8,0.904639175258,1164,510,90.3921568627,41
400087,117,19.4352159468,49,0.844492440605,1389,602,80.5647840532,68
400089,44,8.88888888889,12,0.927398444252,1157,495,91.1111111111,32
412317,16,8.98876404494,5,0.882063882064,407,178,91.0112359551,11
412228,15,5.33807829181,4,0.948995363215,647,281,94.6619217082,11
412186,19,6.69014084507,3,0.94867807154,643,284,93.3098591549,16
412221,14,5.09090909091,7,0.952978056426,638,275,94.9090909091,7
412189,19,6.69014084507,6,0.919939577039,662,284,93.3098591549,13
412225,70,25.5474452555,46,0.75,632,274,74.4525547445,24
412226,23,8.15602836879,5,0.890909090909,660,282,91.8439716312,18
400280,53,12.1281464531,15,0.8798828125,1024,437,87.8718535469,38
400019,42,7.17948717949,42,0.936390532544,1352,585,92.8205128205,0
400018,141,14.9681528662,38,0.861566484517,2196,942,85.0318471338,103
400152,111,18.46921797,49,0.8440433213,1385,601,81.53078203,62
400154,86,9.89643268124,22,0.894606630381,2021,869,90.1035673188,64
400157,61,9.13173652695,17,0.92423252776,1531,668,90.8682634731,44
400158,59,11.8473895582,14,0.891472868217,1161,498,88.1526104418,45
400010,93,10.9799291617,28,0.898073022312,1972,847,89.0200708383,65
400013,120,19.801980198,28,0.815078236131,1406,606,80.198019802,92
412451,3,3.75,3,0.978609625668,187,80,96.25,0
412456,1,1.25,1,0.946808510638,188,80,98.75,0
412457,2,2.46913580247,2,0.978835978836,189,81,97.5308641975,0
400017,113,13.0938586327,48,0.863230921705,2018,863,86.9061413673,65
409888,43,8.54870775348,9,0.908390410959,1168,503,91.4512922465,34
400335,53,10.2912621359,12,0.896093100582,1203,515,89.7087378641,41
400337,121,18.4451219512,50,0.831013916501,1509,656,81.5548780488,71
400331,243,24.570273003,128,0.787786920745,2309,989,75.429726997,115
400333,180,19.5016251354,41,0.801494628678,2141,923,80.4983748646,139
400648,57,15.6164383562,17,0.89349112426,845,365,84.3835616438,40
400640,52,14.5251396648,17,0.878787878788,825,358,85.4748603352,35
400641,49,13.8028169014,17,0.910539215686,816,355,86.1971830986,32
400643,29,7.96703296703,5,0.912529550827,846,364,92.032967033,24
400644,33,9.29577464789,10,0.906892382104,827,355,90.7042253521,23
400645,73,20.9169054441,73,0.777777777778,828,349,79.0830945559,0
400646,15,9.61538461538,15,0.918032786885,366,156,90.3846153846,0
400647,37,10.2209944751,14,0.908872901679,834,362,89.7790055249,23
400349,64,15.1300236407,24,0.886088709677,992,423,84.8699763593,40
412382,16,12.6984126984,2,0.882352941176,289,126,87.3015873016,14
412383,34,25.9541984733,14,0.802631578947,304,131,74.0458015267,20
412386,29,26.1261261261,6,0.79296875,256,111,73.8738738739,23
412385,6,5.66037735849,0,0.876,250,106,94.3396226415,6
412388,12,11.1111111111,10,0.927710843373,249,108,88.8888888889,2
412258,10,4.8309178744,2,0.913043478261,483,207,95.1690821256,8
400209,175,22.9057591623,109,0.799210377891,1773,764,77.0942408377,66
400204,191,23.2077764277,76,0.82477967859,1929,823,76.7922235723,115
400206,100,11.0619469027,37,0.881740775781,2114,904,88.9380530973,63
400207,69,13.717693837,39,0.8480475382,1178,503,86.282306163,30
400419,61,10.0164203612,10,0.895670688432,1409,609,89.9835796388,51
400415,58,13.3333333333,15,0.887033398821,1018,435,86.6666666667,43
400414,158,15.7842157842,85,0.871838834119,2333,1001,84.2157842158,73
400417,185,18.8391038697,81,0.845818815331,2296,982,81.1608961303,104
400416,181,21.4964370546,20,0.785714285714,1974,842,78.5035629454,161
400411,61,13.8952164009,9,0.882468168462,1021,439,86.1047835991,52
400253,192,19.6923076923,25,0.818261633011,2278,975,80.3076923077,167
400343,147,14.7887323944,66,0.8494158373,2311,994,85.2112676056,81
412295,28,15.8192090395,16,0.888349514563,412,177,84.1807909605,12
400288,58,7.6821192053,19,0.915110356537,1767,755,92.3178807947,39
400251,173,20.4009433962,62,0.813360530342,1961,848,79.5990566038,111
412405,9,11.1111111111,9,0.968253968254,189,81,88.8888888889,0
412404,11,14.4736842105,0,0.857954545455,176,76,85.5263157895,11
400257,120,17.8571428571,58,0.822039265358,1579,672,82.1428571429,62
412407,29,36.25,3,0.797872340426,188,80,63.75,26
400114,165,21.3454075032,78,0.819405496354,1783,773,78.6545924968,87
400115,116,11.7647058824,20,0.879861711322,2314,986,88.2352941176,96
400116,180,18.1086519115,89,0.826764833261,2309,994,81.8913480885,91
412406,4,4.93827160494,4,0.962162162162,185,81,95.0617283951,0
400110,196,20.6751054852,61,0.831625835189,2245,948,79.3248945148,135
400111,205,26.4175257732,30,0.768461965575,1801,776,73.5824742268,175
412498,8,15.3846153846,0,0.865546218487,119,52,84.6153846154,8
412499,0,0.0,0,0.990566037736,106,46,100.0,0
412497,21,35.0,5,0.751824817518,137,60,65.0,16
412319,14,7.90960451977,3,0.934306569343,411,177,92.0903954802,11
412252,20,8.19672131148,10,0.896243291592,559,244,91.8032786885,10
412253,21,9.01287553648,5,0.920145190563,551,233,90.9871244635,16
412254,18,7.75862068966,8,0.932203389831,531,232,92.2413793103,10
412255,35,16.2790697674,1,0.849019607843,510,215,83.7209302326,34
412256,12,5.45454545455,0,0.888235294118,510,220,94.5454545455,12
412311,16,9.09090909091,1,0.87684729064,406,176,90.9090909091,15
412259,16,8.42105263158,6,0.923611111111,432,190,91.5789473684,10
412315,27,15.6069364162,9,0.85111662531,403,173,84.3930635838,18
412314,22,13.3333333333,0,0.890306122449,392,165,86.6666666667,22
400291,192,19.9584199584,89,0.84012539185,2233,962,80.0415800416,103
400290,107,18.1049069374,41,0.860805860806,1365,591,81.8950930626,66
400060,40,7.8431372549,4,0.922288642186,1171,510,92.1568627451,36
400061,47,9.1796875,20,0.91395154553,1197,512,90.8203125,27
400062,121,19.1153238547,52,0.841077441077,1485,633,80.8846761453,69
400063,135,22.5752508361,22,0.794927536232,1380,598,77.4247491639,113
412401,2,2.46913580247,2,0.984042553191,188,81,97.5308641975,0
412400,2,2.43902439024,2,0.983957219251,187,82,97.5609756098,0
412403,3,3.7037037037,3,0.989304812834,187,81,96.2962962963,0
412402,1,1.21951219512,1,0.978947368421,190,82,98.7804878049,0
400068,41,9.66981132075,10,0.912087912088,1001,424,90.3301886792,31
412409,2,2.43902439024,2,0.957446808511,188,82,97.5609756098,0
412408,2,2.43902439024,1,0.931578947368,190,82,97.5609756098,1
400151,26,6.03248259861,8,0.910536779324,1006,431,93.9675174014,18
412458,2,2.5974025974,2,0.983870967742,186,77,97.4025974026,0
412452,3,3.75,3,0.957671957672,189,80,96.25,0
412453,9,10.9756097561,8,0.89417989418,189,82,89.0243902439,1
412466,4,4.93827160494,4,0.989247311828,186,81,95.0617283951,0
400367,55,8.16023738872,25,0.909722222222,1584,674,91.8397626113,30
400366,180,18.6528497409,55,0.828090385467,2257,965,81.3471502591,125
400365,175,17.6589303734,107,0.835788561525,2308,991,82.3410696266,68
400364,170,19.7444831591,54,0.817819810851,2009,861,80.2555168409,116
400363,57,13.133640553,21,0.886162904809,1019,434,86.866359447,36
400249,69,14.5569620253,27,0.855605381166,1115,474,85.4430379747,42
400361,77,14.8936170213,23,0.86432160804,1194,517,85.1063829787,54
400360,98,16.2790697674,18,0.838319088319,1404,602,83.7209302326,80
400244,78,9.84848484848,65,0.894994559304,1838,792,90.1515151515,13
400245,161,21.045751634,35,0.794034890264,1777,765,78.954248366,126
400246,189,19.2268565615,54,0.837209302326,2279,983,80.7731434385,135
400247,75,9.38673341677,20,0.903846153846,1872,799,90.6132665832,55
400240,203,21.7112299465,55,0.811614083219,2187,935,78.2887700535,148
412454,4,5.19480519481,4,0.951612903226,186,77,94.8051948052,0
412411,1,1.25,1,0.915789473684,190,80,98.75,0
400129,175,20.8085612366,51,0.817066939193,1957,841,79.1914387634,124
400093,133,19.940029985,36,0.815502882767,1561,667,80.059970015,97
400097,101,19.7265625,40,0.861204013378,1196,512,80.2734375,61
412214,23,8.01393728223,8,0.924471299094,662,287,91.9860627178,15
412215,17,6.34328358209,11,0.943396226415,636,268,93.6567164179,6
412216,29,10.9848484848,7,0.853781512605,595,264,89.0151515152,22
412309,30,16.9491525424,10,0.873479318735,411,177,83.0508474576,20
412476,2,2.46913580247,2,0.978494623656,186,81,97.5308641975,0
412211,9,3.1914893617,3,0.943076923077,650,282,96.8085106383,6
412212,15,5.30035335689,3,0.956325301205,664,283,94.6996466431,12
412213,27,14.2857142857,6,0.867579908676,438,189,85.7142857143,21
412199,13,4.83271375465,7,0.945482866044,642,269,95.1672862454,6
400392,40,8.84955752212,6,0.914645974782,1031,452,91.1504424779,34
412196,44,15.5477031802,14,0.857798165138,654,283,84.4522968198,30
412195,13,4.72727272727,2,0.9375975039,641,275,95.2727272727,11
412194,24,8.57142857143,6,0.925418569254,657,280,91.4285714286,18
412193,17,6.00706713781,8,0.93665158371,663,283,93.9929328622,9
412192,27,9.81818181818,7,0.933539412674,647,275,90.1818181818,20
412191,32,11.3475177305,5,0.916286149163,657,282,88.6524822695,27
412190,40,14.1342756184,0,0.873456790123,648,283,85.8657243816,40
400121,80,11.9225037258,36,0.90449082859,1581,671,88.0774962742,44
400289,187,22.3150357995,39,0.79417773238,1958,838,77.6849642005,148
400124,193,22.9216152019,49,0.799797263051,1973,842,77.0783847981,144
400024,117,19.696969697,46,0.825396825397,1386,594,80.303030303,71
400025,179,19.2266380236,53,0.83448913546,2163,931,80.7733619764,126
400027,82,13.4426229508,32,0.89562764457,1418,610,86.5573770492,50
400021,155,18.8335358445,35,0.813152400835,1916,823,81.1664641555,120
400029,41,9.83213429257,8,0.901740020471,977,417,90.1678657074,33
412449,2,2.5,2,0.973404255319,188,80,97.5,0
400147,57,13.2250580046,27,0.891411648569,1013,431,86.7749419954,30
412440,9,11.1111111111,0,0.882352941176,187,81,88.8888888889,9
400145,51,11.6438356164,22,0.898821218075,1018,438,88.3561643836,29
400144,137,14.2411642412,30,0.878147482014,2224,962,85.7588357588,107
412445,0,0.0,0,0.967741935484,186,80,100.0,0
400142,78,10.064516129,22,0.890539053905,1818,775,89.935483871,56
412447,0,0.0,0,0.957219251337,187,79,100.0,0
400140,162,16.7355371901,39,0.806566104703,2254,968,83.2644628099,123
412500,2,4.44444444444,2,0.971428571429,105,45,95.5555555556,0
412501,4,14.8148148148,0,0.854838709677,62,27,85.1851851852,4
412502,4,36.3636363636,0,0.88,25,11,63.6363636364,4
400321,65,12.8458498024,25,0.890770533446,1181,506,87.1541501976,40
400320,63,9.33333333333,28,0.907547169811,1590,675,90.6666666667,35
400326,138,15.2823920266,59,0.865678776291,2092,903,84.7176079734,79
400657,62,17.1745152355,44,0.877672209026,842,361,82.8254847645,18
400656,31,9.06432748538,7,0.898089171975,785,342,90.9356725146,24
400655,28,7.8431372549,3,0.895558223289,833,357,92.1568627451,25
400654,50,13.9275766017,3,0.883413461538,832,359,86.0724233983,47
400653,51,14.1666666667,6,0.88995215311,836,360,85.8333333333,45
400652,43,12.2159090909,10,0.897218863362,827,352,87.7840909091,33
400651,48,13.9130434783,9,0.863463969659,791,345,86.0869565217,39
400198,161,22.6123595506,15,0.79223880597,1675,712,77.3876404494,146
412209,24,8.60215053763,10,0.932824427481,655,279,91.3978494624,14
400659,38,11.2759643917,4,0.884223918575,786,337,88.7240356083,34
400199,179,23.7400530504,66,0.799205899036,1763,754,76.2599469496,113
400211,198,20.6896551724,107,0.812669683258,2210,957,79.3103448276,91
412398,9,11.1111111111,9,0.94708994709,189,81,88.8888888889,0
400216,203,20.2392821535,93,0.83176369863,2336,1003,79.7607178465,110
412393,3,3.33333333333,2,0.957142857143,210,90,96.6666666667,1
412392,5,5.68181818182,3,0.927536231884,207,88,94.3181818182,2
412395,7,8.53658536585,7,0.920634920635,189,82,91.4634146341,0
412394,4,4.93827160494,1,0.989361702128,188,81,95.0617283951,3
412397,5,6.09756097561,5,0.951086956522,184,82,93.9024390244,0
412396,16,20.253164557,2,0.782608695652,184,79,79.746835443,14
412399,5,6.17283950617,5,0.872340425532,188,81,93.8271604938,0
400195,79,15.5206286837,35,0.870858113849,1177,509,84.4793713163,44
400196,41,8.28282828283,2,0.917383820998,1162,495,91.7171717172,39
400219,106,12.5443786982,48,0.884263959391,1970,845,87.4556213018,58
400218,151,22.1732745962,75,0.799249530957,1599,681,77.8267254038,76
400356,115,17.3716012085,56,0.817711700065,1547,662,82.6283987915,59
400355,53,12.5890736342,13,0.878172588832,985,421,87.4109263658,40
400352,72,16.5517241379,28,0.904433497537,1015,435,83.4482758621,44
400350,173,21.9543147208,37,0.809601745772,1833,788,78.0456852792,136
400351,50,8.36120401338,22,0.889605734767,1395,598,91.6387959866,28
400422,174,19.3118756937,46,0.803214807599,2053,901,80.6881243063,128
400424,186,21.7798594848,42,0.817908954477,1999,854,78.2201405152,144
400425,183,19.635193133,51,0.833104709648,2187,932,80.364806867,132
400103,201,21.1356466877,52,0.829815895824,2227,951,78.8643533123,149
400101,126,18.6943620178,49,0.819338422392,1572,674,81.3056379822,77
412327,10,5.78034682081,2,0.925187032419,401,173,94.2196531792,8
412489,2,2.5,2,0.96256684492,187,80,97.5,0
412488,0,0.0,0,0.973404255319,188,80,100.0,0
412485,5,6.17283950617,5,0.924731182796,186,81,93.8271604938,0
412484,5,6.25,5,0.968085106383,188,80,93.75,0
400109,167,17.1457905544,63,0.835543766578,2262,974,82.8542094456,104
400108,56,13.1764705882,17,0.885511651469,987,425,86.8235294118,39
412481,4,4.87804878049,4,0.968085106383,188,82,95.1219512195,0
412480,1,1.23456790123,1,0.967741935484,186,81,98.7654320988,0
412483,7,8.64197530864,7,0.957894736842,190,81,91.3580246914,0
412482,3,3.7037037037,3,0.973684210526,190,81,96.2962962963,0
412416,3,3.65853658537,3,0.935483870968,186,82,96.3414634146,0
400057,83,9.75323149236,13,0.908722109533,1972,851,90.2467685076,70
412430,3,3.7037037037,3,0.952380952381,189,81,96.2962962963,0
412431,4,4.93827160494,4,0.962962962963,189,81,95.0617283951,0
412432,14,17.9487179487,0,0.837837837838,185,78,82.0512820513,14
400175,40,9.1533180778,17,0.907480314961,1016,437,90.8466819222,23
412434,8,9.75609756098,8,0.935828877005,187,82,90.243902439,0
412435,16,19.512195122,0,0.851851851852,189,82,80.487804878,16
400170,156,19.6473551637,40,0.823114487249,1843,794,80.3526448363,116
400171,50,6.46830530401,17,0.923034021194,1793,773,93.531694696,33
412438,14,17.5,11,0.829787234043,188,80,82.5,3
400076,151,15.5670103093,45,0.850589777195,2289,970,84.4329896907,106
400075,150,17.6886792453,53,0.827291037261,1986,848,82.3113207547,97
400074,84,17.2131147541,31,0.856007067138,1132,488,82.7868852459,53
400178,157,18.6018957346,39,0.819023136247,1945,844,81.3981042654,118
400179,119,18.2515337423,65,0.814488828707,1477,652,81.7484662577,54
400618,69,19.4366197183,31,0.858880778589,822,355,80.5633802817,38
400617,42,11.7647058824,4,0.8787515006,833,357,88.2352941176,38
400616,38,10.3825136612,13,0.90214797136,838,366,89.6174863388,25
400313,37,10.9467455621,8,0.910579345088,794,338,89.0532544379,29
400259,100,19.6850393701,29,0.857624262848,1187,508,80.3149606299,71
400311,124,20.3612479475,51,0.837392550143,1396,609,79.6387520525,73
400316,258,27.3885350318,216,0.741730856366,2207,942,72.6114649682,42
400314,176,21.8091697646,51,0.808328884143,1873,807,78.1908302354,125
400315,40,7.95228628231,13,0.910267471959,1159,503,92.0477137177,27
412294,22,12.5714285714,6,0.883950617284,405,175,87.4285714286,16
400252,109,12.703962704,38,0.888554216867,1992,858,87.296037296,71
400318,184,18.4738955823,77,0.817672413793,2320,996,81.5261044177,107
412290,24,13.4831460674,2,0.857142857143,413,178,86.5168539326,22
412292,12,6.81818181818,0,0.900243309002,411,176,93.1818181818,12
412293,11,6.32183908046,2,0.917274939173,411,174,93.6781609195,9
412474,9,10.9756097561,9,0.878306878307,189,82,89.0243902439,0
412429,9,10.9756097561,9,0.883597883598,189,82,89.0243902439,0
412475,1,1.26582278481,1,0.957219251337,187,79,98.7341772152,0
412428,2,2.43902439024,2,0.989473684211,190,82,97.5609756098,0
400663,30,8.42696629213,6,0.910394265233,837,356,91.5730337079,24
400660,44,12.7536231884,27,0.875305623472,818,345,87.2463768116,17
400661,49,14.0804597701,12,0.885225885226,819,348,85.9195402299,37
412477,2,2.43902439024,1,0.936507936508,189,82,97.5609756098,1
412426,1,1.23456790123,1,0.967914438503,187,81,98.7654320988,0
412471,4,4.87804878049,4,0.941798941799,189,82,95.1219512195,0
412423,4,4.93827160494,3,0.963157894737,190,81,95.0617283951,1
412202,32,11.4695340502,0,0.865648854962,655,279,88.5304659498,32
412200,14,5.0,7,0.943485086342,637,280,95.0,7
412421,2,2.53164556962,2,0.978494623656,186,79,97.4683544304,0
412205,64,22.3776223776,57,0.819277108434,664,286,77.6223776224,7
400227,179,26.5185185185,46,0.764927718416,1591,675,73.4814814815,133
400224,46,10.4783599089,5,0.912023460411,1023,439,89.5216400911,41
412208,18,6.54545454545,6,0.928797468354,632,275,93.4545454545,12
400220,33,7.53424657534,14,0.905138339921,1012,438,92.4657534247,19
400221,77,9.06949352179,25,0.897371081901,1978,849,90.9305064782,52
400388,167,16.9371196755,63,0.823427331887,2305,986,83.0628803245,104
400381,142,14.5342886387,34,0.879964695499,2266,977,85.4657113613,108
400380,146,14.8676171079,122,0.865768896612,2302,982,85.1323828921,24
400387,191,20.9659714599,37,0.805268109125,2126,911,79.0340285401,154
400033,158,23.3038348083,44,0.788220551378,1596,678,76.6961651917,114
400032,34,7.87037037037,7,0.918065153011,1013,432,92.1296296296,27
400031,82,18.8940092166,25,0.88605108055,1018,434,81.1059907834,57
400030,159,18.8165680473,81,0.818599897803,1957,845,81.1834319527,78
412470,12,14.8148148148,0,0.843243243243,185,81,85.1851851852,12
400036,95,11.0851808635,27,0.881822734101,1997,857,88.9148191365,68
412472,7,8.75,7,0.915343915344,189,80,91.25,0
412473,6,7.31707317073,6,0.915789473684,190,82,92.6829268293,0
400039,66,10.6796116505,21,0.911885245902,1464,618,89.3203883495,45
400038,46,10.7476635514,7,0.904714142427,997,428,89.2523364486,39
412478,2,2.43902439024,2,0.967391304348,184,82,97.5609756098,0
412479,5,6.09756097561,5,0.973262032086,187,82,93.9024390244,0
412275,21,11.8644067797,8,0.887254901961,408,177,88.1355932203,13
412272,24,13.5593220339,5,0.892420537897,409,177,86.4406779661,19
412379,14,9.52380952381,2,0.933933933934,333,147,90.4761904762,12
412270,21,11.797752809,7,0.891358024691,405,178,88.202247191,14
412271,23,13.0681818182,4,0.905109489051,411,176,86.9318181818,19
400133,176,21.5422276622,40,0.802780638517,1942,817,78.4577723378,136
400130,182,24.6612466125,63,0.810575246949,1721,738,75.3387533875,119
400137,48,9.73630831643,9,0.891304347826,1150,493,90.2636916836,39
400134,87,17.125984252,69,0.821367521368,1170,508,82.874015748,18
400100,216,22.3834196891,72,0.787111111111,2250,965,77.6165803109,144
412420,6,7.59493670886,6,0.924731182796,186,79,92.4050632911,0
400090,131,18.5552407932,42,0.817354368932,1648,706,81.4447592068,89
412278,23,13.2183908046,0,0.914215686275,408,174,86.7816091954,23
412487,3,3.75,3,0.936842105263,190,80,96.25,0
400046,40,5.96125186289,12,0.908626198083,1565,671,94.0387481371,28
400047,116,18.8617886179,54,0.844228094576,1438,615,81.1382113821,62
412486,4,4.87804878049,4,0.967914438503,187,82,95.1219512195,0
400042,134,20.0899550225,77,0.818527918782,1576,667,79.9100449775,57
400048,160,19.2539109507,68,0.825338894682,1918,831,80.7460890493,92
412010,48,14.4144144144,1,0.87146529563,778,333,85.5855855856,47
412011,29,9.66666666667,11,0.88293370945,709,300,90.3333333333,18
400622,37,10.7558139535,10,0.888198757764,805,344,89.2441860465,27
400623,43,12.0786516854,10,0.923926380368,815,356,87.9213483146,33
400626,35,9.74930362117,9,0.914663461538,832,359,90.2506963788,26
400627,32,9.27536231884,6,0.899378881988,805,345,90.7246376812,26
400628,52,14.3250688705,38,0.862559241706,844,363,85.6749311295,14
412217,34,11.8881118881,1,0.871406959153,661,286,88.1118881119,33
400262,175,18.4210526316,26,0.820455560518,2239,950,81.5789473684,149
400263,143,20.6051873199,51,0.821339950372,1612,694,79.3948126801,92
400189,183,18.4848484848,70,0.854229934924,2305,990,81.5151515152,113
400266,179,26.0174418605,150,0.776175548589,1595,688,73.9825581395,29
400267,82,9.57943925234,21,0.907769423559,1995,856,90.4205607477,61
400183,174,20.2325581395,90,0.801002506266,1995,860,79.7674418605,84
400185,82,16.5322580645,21,0.858125537403,1163,496,83.4677419355,61
400184,109,17.9571663921,40,0.839096683133,1417,607,82.0428336079,69
400436,173,20.4491725768,49,0.811387900356,1967,846,79.5508274232,124
400435,167,16.7670682731,69,0.864086021505,2325,996,83.2329317269,98
400433,53,11.2288135593,15,0.909173478656,1101,472,88.7711864407,38
400348,117,13.700234192,78,0.866229177183,1981,854,86.299765808,39
400431,83,10.8638743455,39,0.916481069042,1796,764,89.1361256545,44
400345,123,24.0704500978,92,0.813232830821,1194,511,75.9295499022,31
400344,125,13.1856540084,73,0.8800180424,2217,948,86.8143459916,52
400347,183,21.3785046729,25,0.818639798489,1985,856,78.6214953271,158
400346,135,20.059435364,49,0.817602040816,1568,673,79.940564636,86
400341,61,13.9269406393,8,0.8828125,1024,438,86.0730593607,53
400340,123,12.4117053481,38,0.879826464208,2305,991,87.5882946519,85
400439,143,15.5943293348,60,0.867281105991,2170,917,84.4056706652,83
400342,65,12.8458498024,10,0.910397295013,1183,506,87.1541501976,55
400310,168,18.2807399347,68,0.813606710158,2146,919,81.7192600653,100
412331,25,15.1515151515,2,0.88409703504,371,165,84.8484848485,23
412239,19,6.81003584229,9,0.928134556575,654,279,93.1899641577,10
412231,47,16.4335664336,37,0.818045112782,665,286,83.5664335664,10
412236,14,4.94699646643,6,0.945904173107,647,283,95.0530035336,8
400165,213,21.7791411043,172,0.792725679229,2282,978,78.2208588957,41
400008,201,22.1122112211,101,0.819114219114,2145,909,77.8877887789,100
400009,77,14.2592592593,34,0.862014274385,1261,540,85.7407407407,43
400160,174,20.8133971292,88,0.820803295572,1942,836,79.1866028708,86
400163,180,22.3880597015,33,0.797340425532,1880,804,77.6119402985,147
400162,56,12.8146453089,12,0.869223205506,1017,437,87.1853546911,44
412427,2,2.43902439024,2,0.968253968254,189,82,97.5609756098,0
400003,181,19.6739130435,59,0.843663274746,2162,920,80.3260869565,122
412424,9,11.1111111111,9,0.89010989011,182,81,88.8888888889,0
400006,66,15.313225058,31,0.849056603774,1007,431,84.686774942,35
412422,6,7.31707317073,6,0.952631578947,190,82,92.6829268293,0
400004,71,10.4105571848,25,0.8975,1600,682,89.5894428152,46
400005,55,11.0220440882,19,0.911636045494,1143,499,88.9779559118,36
400378,182,19.2389006342,57,0.83744948361,2227,946,80.7610993658,125
